"born","origin","board","bus","arrive","destination","eventPtr","alg","distance","service.time"
2.14749728997561,1,3,2,36.6568566246647,9,1,"elevator",8,34.5093593346891
2.87403698371027,1,3,2,11.7415068865666,4,1,"elevator",3,8.86746990285633
3.47533178295244,1,29.761137437196,4,45.1967874587016,10,1,"elevator",9,41.7214556757492
4.65072648316799,1,30.769293232712,5,35.0301128227513,3,1,"elevator",2,30.3793863395833
4.68152030041619,1,30.769293232712,5,45.9991285557924,5,1,"elevator",4,41.3176082553762
6.31674034741865,1,30.769293232712,5,35.0301128227513,3,1,"elevator",2,28.7133724753326
6.39328113232897,1,30.769293232712,5,49.9080224799625,6,1,"elevator",5,43.5147413476335
7.27951603599506,1,30.769293232712,5,44.9894978484935,4,1,"elevator",3,37.7099818124984
7.50063734911159,1,30.769293232712,5,51.7937743525134,8,1,"elevator",7,44.2931370034018
9.04713106929082,1,30.769293232712,5,44.9894978484935,4,1,"elevator",3,35.9423667792027
1.636411935007,2,3.41921482413056,1,18.9287204214709,6,1,"elevator",4,17.2923084864639
1.83941006558927,2,3.41921482413056,1,24.5461293472668,10,1,"elevator",8,22.7067192816775
1.96955711665543,2,3.41921482413056,1,23.1596479385385,9,1,"elevator",7,21.1900908218831
2.77087899005476,2,3.41921482413056,1,18.9287204214709,6,1,"elevator",4,16.1578414314161
3.49106151314412,2,4.74708628935913,2,33.7598514249677,8,1,"elevator",6,30.2687899118236
4.33332820774667,2,31.7390351430494,4,37.486355306626,5,1,"elevator",3,33.1530270988793
4.47075368303485,2,31.7390351430494,4,40.3467098686944,8,1,"elevator",6,35.8759561856595
5.29817586041191,2,31.7390351430494,4,37.1604945588089,4,1,"elevator",2,31.862318698397
5.31388670087927,2,31.7390351430494,4,38.5749065993219,7,1,"elevator",5,33.2610198984426
7.09242455348488,2,31.7390351430494,4,37.486355306626,5,1,"elevator",3,30.3939307531411
1.44788782112507,3,5.98470620620629,2,21.0708017709632,6,1,"elevator",3,19.6229139498381
2.07857733359767,3,5.98470620620629,2,12.812946666,5,1,"elevator",2,10.7343693324023
3.05625198544666,3,5.98470620620629,2,12.812946666,5,1,"elevator",2,9.75669468055334
3.81496168299613,3,5.98470620620629,2,36.6568566246647,9,1,"elevator",6,32.8418949416686
3.82441120742788,3,5.98470620620629,2,37.6410422562801,10,1,"elevator",7,33.8166310488522
4.04600457250108,3,22.6093389873552,4,26.7773848562806,1,1,"elevator",2,22.7313802837795
4.65022809951534,3,5.98470620620629,2,37.6410422562801,10,1,"elevator",7,32.9908141567648
4.69013947210242,3,22.6093389873552,4,26.7773848562806,1,1,"elevator",2,22.0872453841782
4.72508413599786,3,5.98470620620629,2,26.1961060586669,7,1,"elevator",4,21.471021922669
6.44374508657454,3,10.0755920970646,1,23.1596479385385,9,1,"elevator",6,16.715902851964
0.351469358429313,4,11.8911874380819,1,23.1596479385385,9,1,"elevator",5,22.8081785801092
1.07151046705743,4,11.8911874380819,1,18.9287204214709,6,1,"elevator",2,17.8572099544135
14.8056411456766,4,37.1604945588089,4,43.7106146136964,9,1,"elevator",5,28.9049734680198
2.96971453379192,5,3,3,9.80405880776483,7,1,"elevator",2,6.83434427397291
11.7858105275364,5,24,3,34.449996850666,10,1,"elevator",5,22.6641863231296
13.1839904979076,5,37.486355306626,4,40.3467098686944,8,1,"elevator",3,27.1627193707868
0.650893258862197,6,18.3723475134222,5,22.2196275365842,2,1,"elevator",4,21.568734277722
3.37598182244175,6,18.8536303465551,4,24.8642413477627,2,1,"elevator",4,21.4882595253209
4.21036088356697,6,5.19053454408493,3,10.7483888729447,8,1,"elevator",2,6.53802798937773
3.29561423555604,7,14.2795941343192,5,22.2196275365842,2,1,"elevator",5,18.9240133010282
9.39276805785695,7,14.2795941343192,5,20.0857027303649,5,1,"elevator",2,10.692934672508
11.541611656409,7,14.2795941343192,5,20.4368969356572,4,1,"elevator",3,8.8952852792482
1.9632137613371,8,6.78549165018689,4,8.18339160807289,10,1,"elevator",2,6.22017784673579
13.8118846195268,8,15.0894649040772,4,24.8642413477627,2,1,"elevator",6,11.0523567282359
17.922161129084,8,29.3307530632755,1,42.0992912122227,2,1,"elevator",6,24.1771300831387
1.62475671552335,9,6.52884818960853,5,18.3723475134222,6,1,"elevator",3,16.7475907978988
2.09343120863605,9,6.52884818960853,5,22.2196275365842,2,1,"elevator",7,20.1261963279481
5.89509822511646,9,6.52884818960853,5,18.3723475134222,6,1,"elevator",3,12.4772492883057
4.55865971419617,10,13.0047984100674,4,24.8642413477627,2,1,"elevator",8,20.3055816335665
16.7965450441711,10,27.8494776655123,1,29.3307530632755,8,1,"elevator",2,12.5342080191044
21.277440661387,10,27.8494776655123,1,45.3321301602335,1,1,"elevator",9,24.0546894988465
1.83584305821898,1,2,2,18.688184602315,5,1,"elevator",4,16.852341544096
2.23668390371594,1,24.5441388546272,4,31.5707319534612,4,1,"elevator",3,29.3340480497453
2.50628818710092,1,24.5441388546272,4,31.5707319534612,4,1,"elevator",3,29.0644437663603
5.42518728348144,1,24.5441388546272,4,29.5759071837798,3,1,"elevator",2,24.1507199002984
7.07062484251032,1,24.5441388546272,4,31.5707319534612,4,1,"elevator",3,24.5001071109509
7.77921057259686,1,24.5441388546272,4,31.5707319534612,4,1,"elevator",3,23.7915213808643
8.255693593994,1,24.5441388546272,4,29.5759071837798,3,1,"elevator",2,21.3202135897858
8.26057435803823,1,24.5441388546272,4,44.9457822679668,10,1,"elevator",9,36.6852079099286
10.6050061922076,1,24.5441388546272,4,31.5707319534612,4,1,"elevator",3,20.9657257612536
12.3843671793696,1,24.5441388546272,4,41.3465377607045,8,1,"elevator",7,28.9621705813349
2.99709462357645,2,6.06495048538211,1,23.9216064003313,8,1,"elevator",6,20.9245117767548
3.07521490683738,2,6.06495048538211,1,19.3504220628056,7,1,"elevator",5,16.2752071559682
5.19587766483821,2,6.06495048538211,1,10.1014369769522,4,1,"elevator",2,4.90555931211399
5.21403265464187,2,6.06495048538211,1,28.7933383511725,10,1,"elevator",8,23.5793056965306
5.85598322887972,2,6.06495048538211,1,12.3665159928272,5,1,"elevator",3,6.51053276394748
5.9896662546165,2,6.06495048538211,1,23.9216064003313,8,1,"elevator",6,17.9319401457148
6.37501845404801,2,35.992640347732,5,47.2786517938582,7,1,"elevator",5,40.9036333398102
9.84232273386571,2,27.7334108117331,4,44.9457822679668,10,1,"elevator",8,35.1034595341011
11.3351164026411,2,27.7334108117331,4,44.4128354465264,9,1,"elevator",7,33.0777190438853
12.04360525811,2,35.992640347732,5,42.2619474989129,6,1,"elevator",4,30.2183422408029
0.45826866918947,3,6.59006181706615,4,15.8926490522719,1,1,"elevator",2,15.4343803830824
1.3521897259098,3,5.38886899306419,2,24.5118193278702,10,1,"elevator",7,23.1596296019604
1.76501678507072,3,5.38886899306419,2,21.8636907464183,8,1,"elevator",5,20.0986739613476
2.35262277926546,3,5.38886899306419,2,23.4262014420615,9,1,"elevator",6,21.073578662796
3.27469560797079,3,5.38886899306419,2,23.4262014420615,9,1,"elevator",6,20.1515058340907
3.98921188069715,3,5.38886899306419,2,21.8636907464183,8,1,"elevator",5,17.8744788657212
4.70974147045717,3,5.38886899306419,2,19.672420002156,6,1,"elevator",3,14.9626785316988
4.74558691546053,3,6.59006181706615,4,15.8926490522719,1,1,"elevator",2,11.1470621368114
7.00445362592284,3,20.2725920466957,5,23.3695716703359,1,1,"elevator",2,16.3651180444131
8.41024262488968,3,29.5759071837798,4,44.4128354465264,9,1,"elevator",6,36.0025928216367
0.718671965054169,4,31.5707319534612,4,41.3465377607045,8,1,"elevator",4,40.6278657956503
3.75935909009033,4,37.2127100477111,5,42.2619474989129,6,1,"elevator",2,38.5025884088226
6.24309133175117,4,31.5707319534612,4,38.9071719887237,7,1,"elevator",3,32.6640806569725
5.65908128395801,5,36.9981767002995,4,38.9071719887237,7,1,"elevator",2,33.2480907047657
10.4489763815603,5,32.0459663627178,3,35.3298357051397,3,1,"elevator",2,24.8808593235794
13.7990753117581,5,36.9981767002995,4,44.9457822679668,10,1,"elevator",5,31.1467069562087
4.74331281761407,6,8.69717609738473,5,20.2725920466957,3,1,"elevator",3,15.5292792290816
4.75194986436595,6,5.23993100970984,3,15.1939240070981,9,1,"elevator",3,10.4419741427321
6.62732347621488,6,8.69717609738473,5,13.2648090193676,4,1,"elevator",2,6.63748554315272
0.00949687134416117,7,6.92059578686495,5,23.3695716703359,1,1,"elevator",6,23.3600747989917
11.3688572875143,7,27.8207912602622,3,39.0863860424532,1,1,"elevator",6,27.7175287549389
18.1565228977463,7,19.3504220628056,1,28.4187141869507,9,1,"elevator",2,10.2621912892044
13.0338600457164,8,21.8636907464183,2,24.5118193278702,10,1,"elevator",2,11.4779592821538
14.1319944810535,8,21.8636907464183,2,24.5118193278702,10,1,"elevator",2,10.3798248468167
14.6984951081788,8,27.1446979637318,3,28.0318692121492,6,1,"elevator",2,13.3333741039704
0.238660086567203,9,2.14709313493222,5,20.2725920466957,3,1,"elevator",6,20.0339319601285
1.97676601974914,9,2.14709313493222,5,8.69717609738473,6,1,"elevator",3,6.72041007763559
10.204662118747,9,25.5917939129066,3,27.8207912602622,7,1,"elevator",2,17.6161291415152
3.86708438410784,10,26.713306259984,2,42.4667822127213,5,1,"elevator",5,38.5996978286135
9.9302240646008,10,35.2541136812302,1,45.3580124817612,6,1,"elevator",4,35.4277884171604
10.1300622304155,10,24.5357233215785,3,27.8207912602622,7,1,"elevator",3,17.6907290298467
0.171612387980027,1,1,1,16.0730921949202,7,1,"elevator",6,15.9014798069402
0.755443096617861,1,1,1,18.9488610024584,10,1,"elevator",9,18.1934179058405
1.88134161145013,1,2,2,33.2396261994293,10,1,"elevator",9,31.3582845879792
2.07284666453075,1,14.1349387907735,4,41.2321040495054,10,1,"elevator",9,39.1592573849747
2.31211108622068,1,14.1349387907735,4,37.5565234555641,9,1,"elevator",8,35.2444123693434
3.21605141643817,1,14.1349387907735,4,21.8320521194784,3,1,"elevator",2,18.6160007030402
4.01562124296929,1,14.1349387907735,4,25.4572818746922,5,1,"elevator",4,21.4416606317229
4.57567267531435,1,14.1349387907735,4,34.3295899906565,7,1,"elevator",6,29.7539173153422
5.46071164201085,1,14.1349387907735,4,41.2321040495054,10,1,"elevator",9,35.7713924074946
5.48821430311609,1,14.1349387907735,4,24.384791704356,4,1,"elevator",3,18.8965774012399
3.328243329953,2,17.2689533854437,4,25.4572818746922,5,1,"elevator",3,22.1290385447392
3.54380452988629,2,17.2689533854437,4,37.5565234555641,9,1,"elevator",7,34.0127189256778
3.61947035803219,2,17.2689533854437,4,37.5565234555641,9,1,"elevator",7,33.9370530975319
4.72021709392062,2,17.2689533854437,4,24.384791704356,4,1,"elevator",2,19.6645746104354
6.35176711903148,2,17.2689533854437,4,34.3295899906565,7,1,"elevator",5,27.977822871625
9.49091028386021,2,17.2689533854437,4,24.384791704356,4,1,"elevator",2,14.8938814204958
9.89220070383737,2,17.2689533854437,4,41.2321040495054,10,1,"elevator",8,31.339903345668
11.616018050132,2,17.2689533854437,4,41.2321040495054,10,1,"elevator",8,29.6160859993734
12.903644419015,2,17.2689533854437,4,37.5565234555641,9,1,"elevator",7,24.6528790365491
14.147691321257,2,17.2689533854437,4,36.1501277674144,8,1,"elevator",6,22.0024364461574
0.195436133519971,3,6.91661860366429,4,11.8429566312142,1,1,"elevator",2,11.6475204976942
0.317873865814173,3,3.51733873758059,1,16.0730921949202,7,1,"elevator",4,15.755218329106
2.40666633690327,3,3.51733873758059,1,15.1745088470343,6,1,"elevator",3,12.767842510131
2.62349325404123,3,3.51733873758059,1,16.9540278233957,8,1,"elevator",5,14.3305345693545
2.68581360519652,3,9.1872310553728,2,10.0535523117648,5,1,"elevator",2,7.36773870656828
3.60256056424475,3,9.1872310553728,2,28.8828844266831,9,1,"elevator",6,25.2803238624383
4.19488554571068,3,9.1872310553728,2,18.3088699547244,7,1,"elevator",4,14.1139844090137
5.23207696691761,3,9.1872310553728,2,10.0535523117648,5,1,"elevator",2,4.82147534484719
7.26005513935936,3,9.1872310553728,2,33.2396261994293,10,1,"elevator",7,25.9795710600699
8.12546186957119,3,9.1872310553728,2,28.8828844266831,9,1,"elevator",6,20.7574225571119
1.05470105074346,4,9.89215728399697,2,28.8828844266831,9,1,"elevator",5,27.8281833759396
2.58130310517895,4,9.89215728399697,2,20.4242026256598,8,1,"elevator",4,17.8428995204808
3.75309606031674,4,4.88905082253699,4,11.8429566312142,1,1,"elevator",3,8.08986057089746
0.517372296502193,5,1,3,6.02033373378322,8,1,"elevator",3,5.50296143728103
2.85548655754492,5,10.0535523117648,2,20.4242026256598,8,1,"elevator",3,17.5687160681149
8.1725342085302,5,31.3857761019123,3,36.0775895013825,3,1,"elevator",2,27.9050552928523
0.349919406049791,6,4.18727920116631,5,11.8459329821975,3,1,"elevator",3,11.4960135761477
6.67772000749054,6,27.689507693559,3,33.5513329117263,4,1,"elevator",2,26.8736129042358
9.65119254233983,6,34.850877241138,5,37.6152083336094,9,1,"elevator",3,27.9640157912696
0.929028508253396,7,4.07914699202237,3,8.13736494017207,10,1,"elevator",3,7.20833643191867
3.82619095657762,7,26.1896559082039,3,33.5513329117263,4,1,"elevator",3,29.7251419551487
6.09050743594265,7,28.0722794884775,1,38.1877225997345,5,1,"elevator",2,32.0972151637919
2.89617654232585,8,3.73378691534492,5,19.0089822238338,1,1,"elevator",7,16.112805681508
5.02604293933415,8,23.4903094280961,1,33.7451022010064,6,1,"elevator",2,28.7190592616722
5.36509383425985,8,23.4903094280961,1,38.1877225997345,5,1,"elevator",3,32.8226287654746
6.73003302238194,9,15.1329503711433,3,36.0775895013825,3,1,"elevator",6,29.3475564790006
7.4955024194897,9,15.1329503711433,3,42.3656197721479,1,1,"elevator",8,34.8701173526582
8.77001378346789,9,15.1329503711433,3,27.689507693559,6,1,"elevator",3,18.9194939100911
9.95538325391647,10,13.5157734605982,3,26.1896559082039,7,1,"elevator",3,16.2342726542874
11.4037011955051,10,13.5157734605982,3,36.1963531536579,2,1,"elevator",8,24.7926519581528
13.6231814079725,10,20.302605681348,1,28.0722794884775,7,1,"elevator",3,14.449098080505
0.0515322666615248,1,1,1,13.7455441528203,4,1,"elevator",3,13.6940118861588
0.94718335564704,1,1,1,27.3425103627815,10,1,"elevator",9,26.3953270071345
1.40254518944294,1,2,2,3.32130920639742,3,1,"elevator",2,1.91876401695448
1.76629753918843,1,2,2,3.32130920639742,3,1,"elevator",2,1.55501166720899
2.15360204778136,1,13.4699346161442,3,42.4859530577991,9,1,"elevator",8,40.3323510100177
3.09046796980294,1,13.4699346161442,3,37.2800000570763,7,1,"elevator",6,34.1895320872734
3.44290335561129,1,13.4699346161442,3,42.4859530577991,9,1,"elevator",8,39.0430497021878
4.9234383709911,1,13.4699346161442,3,46.547726306804,10,1,"elevator",9,41.6242879358129
4.93977203968879,1,13.4699346161442,3,32.1842822102969,5,1,"elevator",4,27.2445101706081
5.74907960742203,1,13.4699346161442,3,35.8843195450348,6,1,"elevator",5,30.1352399376128
0.559543574694544,2,7.40261087605893,1,18.7299346376086,6,1,"elevator",4,18.1703910629141
1.55711846561627,2,7.40261087605893,1,18.7299346376086,6,1,"elevator",4,17.1728161719923
3.1496804965331,2,7.40261087605893,1,23.5919159876295,8,1,"elevator",6,20.4422354910964
3.51465826143015,2,7.40261087605893,1,13.7455441528203,4,1,"elevator",2,10.2308858913901
4.47787742638866,2,7.40261087605893,1,16.6210010872284,5,1,"elevator",3,12.1431236608397
4.87148388486405,2,7.40261087605893,1,21.6877464667609,7,1,"elevator",5,16.8162625818969
5.22277907572736,2,7.40261087605893,1,13.7455441528203,4,1,"elevator",2,8.52276507709294
6.84560013258904,2,7.40261087605893,1,16.6210010872284,5,1,"elevator",3,9.77540095463936
7.1472621566996,2,16.3199546431131,3,35.8843195450348,6,1,"elevator",4,28.7370573883352
7.37341413296834,2,16.3199546431131,3,24.1727017786503,4,1,"elevator",2,16.799287645682
0.802320949113889,3,3.32130920639742,2,15.1765228060927,10,1,"elevator",7,14.3742018569788
1.12812782343008,3,3.32130920639742,2,13.3337275487177,8,1,"elevator",5,12.2055997252876
3.81240214472603,3,20.4400024390985,3,46.547726306804,10,1,"elevator",7,42.735324162078
4.82546655303946,3,20.4400024390985,3,32.1842822102969,5,1,"elevator",2,27.3588156572574
5.679237876155,3,37.0767006262546,5,44.0722318243148,9,1,"elevator",6,38.3929939481598
6.18034130807272,3,20.4400024390985,3,42.4859530577991,9,1,"elevator",6,36.3056117497264
6.64199263143591,3,20.4400024390985,3,32.1842822102969,5,1,"elevator",2,25.542289578861
7.16094893316976,3,20.4400024390985,3,37.2800000570763,7,1,"elevator",4,30.1190511239065
7.75420627717972,3,8.17150889684386,3,10.4577999655061,1,1,"elevator",2,2.70359368832638
9.54055945169273,3,20.4400024390985,3,35.8843195450348,6,1,"elevator",3,26.3437600933421
6.3043919575394,4,33.173972265184,1,36.1666657369295,2,1,"elevator",2,29.8622737793901
8.83895456128033,4,19.3748831149551,5,28.9198517088754,2,1,"elevator",2,20.0808971475951
8.85343964169634,4,24.1727017786503,3,37.2800000570763,7,1,"elevator",3,28.42656041538
4.2524247553041,5,10.8168277369534,2,13.3337275487177,8,1,"elevator",3,9.0813027934136
10.3334515160189,5,16.2315668745501,5,24.4332182869483,3,1,"elevator",2,14.0997667709294
18.6211509678897,5,32.9654483840892,1,36.1666657369295,2,1,"elevator",3,17.5455147690398
1.12342607385168,6,14.2644340180408,5,19.3748831149551,4,1,"elevator",2,18.2514570411034
9.60176066298249,6,11.3729354777923,2,15.1765228060927,10,1,"elevator",4,5.57476214311021
9.98857233010443,6,11.3729354777923,2,13.8644526269093,9,1,"elevator",3,3.87588029680487
1.53395009847979,7,7.44664799777751,5,16.2315668745501,5,1,"elevator",2,14.6976167760703
2.28359055860589,7,10.0661437247313,4,15.5798783896835,9,1,"elevator",2,13.2962878310776
2.82785562491801,7,7.44664799777751,5,19.3748831149551,4,1,"elevator",3,16.5470274900371
4.52346056996191,8,24.8297479230919,2,39.6994856423912,1,1,"elevator",7,35.1760250724293
18.5033117767257,8,24.8297479230919,2,35.5967497082588,3,1,"elevator",5,17.0934379315331
19.1274800202954,8,26.9312529778909,4,37.1562628122638,6,1,"elevator",2,18.0287827919684
6.37422881992467,9,23.1110404020708,2,39.6994856423912,1,1,"elevator",8,33.3252568224665
9.15598987870129,9,26.5887355857857,4,35.8006888216484,7,1,"elevator",2,26.6446989429471
10.4062107014925,9,23.1110404020708,2,38.0212775473838,2,1,"elevator",7,27.6150668458913
5.07721372372323,10,20.6904231966831,2,38.0212775473838,2,1,"elevator",8,32.9440638236606
6.18210512481793,10,20.6904231966831,2,38.0212775473838,2,1,"elevator",8,31.8391724225659
7.05576224831406,10,19.7149742854464,4,37.1562628122638,6,1,"elevator",4,30.1005005639497
0.180089667905122,1,1,1,20.5057149016393,5,1,"elevator",4,20.3256252337342
0.616007359698415,1,1,1,34.0145822927952,10,1,"elevator",9,33.3985749330968
1.46244296893002,1,2,2,6.21576035108711,4,1,"elevator",3,4.75331738215709
3.06433190858427,1,26.8251400785623,2,55.6098945258464,9,1,"elevator",8,52.5455626172621
5.74454026550926,1,26.8251400785623,2,47.4977739754181,8,1,"elevator",7,41.7532337099088
6.58786588970968,1,30.0257192383142,3,37.3423762378955,4,1,"elevator",3,30.7545103481858
7.0556232097412,1,30.0257192383142,3,34.3046854742053,3,1,"elevator",2,27.2490622644641
7.36275800940045,1,26.8251400785623,2,46.5586841593544,7,1,"elevator",6,39.1959261499539
8.22252080649058,1,26.8251400785623,2,46.5586841593544,7,1,"elevator",6,38.3361633528638
8.9618675221841,1,30.0257192383142,3,34.3046854742053,3,1,"elevator",2,25.3428179520212
0.661172579042614,2,3.73682495869079,2,6.21576035108711,4,1,"elevator",2,5.5545877720445
1.07103205891326,2,3.73682495869079,2,9.36070949593686,7,1,"elevator",5,8.2896774370236
1.30857355939224,2,3.73682495869079,2,6.21576035108711,4,1,"elevator",2,4.90718679169487
2.31603886757812,2,3.73682495869079,2,6.21576035108711,4,1,"elevator",2,3.89972148350899
7.46507097018182,2,11.7630987914022,1,24.8753028042703,7,1,"elevator",5,17.4102318340885
8.1784852830854,2,11.7630987914022,1,24.8753028042703,7,1,"elevator",5,16.6968175211849
8.26460503685966,2,11.7630987914022,1,20.5057149016393,5,1,"elevator",3,12.2411098647796
12.5324129561397,2,27.5876480891551,5,39.1114461285344,5,1,"elevator",3,26.5790331723947
13.1426188220704,2,33.8648694543438,3,45.2679705048896,8,1,"elevator",6,32.1253516828192
15.3678767867492,2,33.8648694543438,3,37.3423762378955,4,1,"elevator",2,21.9744994511463
0.933698552517176,3,17.6751145421065,1,34.0145822927952,10,1,"elevator",7,33.080883740278
1.37036297921646,3,17.6751145421065,1,27.2648006622316,9,1,"elevator",6,25.8944376830151
2.33775704149236,3,4.29054935700518,3,12.2935224053,1,1,"elevator",2,9.95576536380764
2.7514827448856,3,17.6751145421065,1,22.2603986061874,6,1,"elevator",3,19.5089158613018
3.43576893973909,3,4.29054935700518,3,12.2935224053,1,1,"elevator",2,8.85775346556091
4.12612933870218,3,17.6751145421065,1,24.8753028042703,7,1,"elevator",4,20.7491734655681
5.376932469339,3,17.6751145421065,1,34.0145822927952,10,1,"elevator",7,28.6376498234562
6.87000959131356,3,17.6751145421065,1,34.0145822927952,10,1,"elevator",7,27.1445727014816
8.09027288894114,3,17.6751145421065,1,34.0145822927952,10,1,"elevator",7,25.9243094038541
10.7417523323503,3,17.4294562144962,2,22.4101944079709,1,1,"elevator",2,11.6684420756206
0.760007561323371,4,6.21576035108711,2,9.36070949593686,7,1,"elevator",3,8.60070193461349
7.25711783845763,4,29.1739247207853,5,46.6997161407166,8,1,"elevator",4,39.442598302259
7.6806652761826,4,13.5002850629032,2,22.4101944079709,1,1,"elevator",3,14.7295291317883
7.71985933262758,5,11.90326103211,2,19.3961544075432,2,1,"elevator",3,11.6762950749156
7.99875602514696,5,11.90326103211,2,22.4101944079709,1,1,"elevator",4,14.4114383828239
14.6127808688875,5,20.5057149016393,1,27.2648006622316,9,1,"elevator",4,12.6520197933441
2.07442046453555,6,10.1651354358434,2,17.4294562144962,3,1,"elevator",3,15.3550357499606
2.81126589048654,6,3.74719200833681,4,14.1749683726693,10,1,"elevator",4,11.3637024821828
2.94045544451192,6,10.1651354358434,2,19.3961544075432,2,1,"elevator",4,16.4556989630313
4.73666337601153,7,6.91019730228598,4,12.9476416986813,9,1,"elevator",2,8.21097832266977
4.95010171497689,7,6.91019730228598,4,14.1749683726693,10,1,"elevator",3,9.22486665769241
15.788301121279,7,28.8364599370014,4,32.9643384071783,4,1,"elevator",3,17.1760372858993
0.134431090071978,8,8.81989221836872,5,18.7427674051961,4,1,"elevator",4,18.6083363151241
5.49490823431141,8,8.81989221836872,5,25.9563782084284,1,1,"elevator",7,20.461469974117
6.07675529105789,8,8.81989221836872,5,25.9563782084284,1,1,"elevator",7,19.8796229173705
0.516398381482273,9,5.73145818429813,5,11.9541129803927,7,1,"elevator",2,11.4377145989104
8.97296030036393,9,16.9271091632161,4,38.6015068001815,1,1,"elevator",8,29.6285464998176
16.6812860150585,9,36.2231885563159,1,42.5705936915935,5,1,"elevator",4,25.889307676535
0.951421375696858,10,1,5,25.9563782084284,1,1,"elevator",9,25.0049568327315
1.5299207599296,10,14.8572488618078,4,34.3433048596624,3,1,"elevator",7,32.8133840997328
8.80843234244805,10,14.8572488618078,4,25.4015930017063,8,1,"elevator",2,16.5931606592582
1.79836632675471,1,2,2,12.2384885402451,6,1,"elevator",5,10.4401222134904
1.93794936259257,1,2,2,4.04139676117602,4,1,"elevator",3,2.10344739858345
3.05877376940537,1,15.1274165357178,4,29.1872996265119,6,1,"elevator",5,26.1285258571065
3.63727554500065,1,15.1274165357178,4,21.3425154278874,3,1,"elevator",2,17.7052398828867
6.79022807591547,1,15.1274165357178,4,30.3562848954264,7,1,"elevator",6,23.5660568195109
6.89696370447938,1,15.1274165357178,4,25.8907946601365,5,1,"elevator",4,18.9938309556571
7.45267967474391,1,15.1274165357178,4,37.5352371841098,9,1,"elevator",8,30.0825575093659
9.49050659645073,1,15.1274165357178,4,42.6033693581772,10,1,"elevator",9,33.1128627617265
12.197035202218,1,15.1274165357178,4,35.6161297871808,8,1,"elevator",7,23.4190945849628
12.9803108474022,1,15.1274165357178,4,23.7422341397181,4,1,"elevator",3,10.7619232923159
0.268884005650868,2,2.63089860857437,1,10.656109423529,4,1,"elevator",2,10.3872254178781
0.292083210937669,2,2.63089860857437,1,14.8478846226897,6,1,"elevator",4,14.555801411752
1.60772994777829,2,2.63089860857437,1,17.4022437031394,9,1,"elevator",7,15.7945137553611
1.850394922011,2,2.63089860857437,1,17.0512008019672,8,1,"elevator",6,15.2008058799562
4.33768879672988,2,20.166926787582,4,25.8907946601365,5,1,"elevator",3,21.5531058634066
4.38352806542933,2,20.166926787582,4,42.6033693581772,10,1,"elevator",8,38.2198412927479
4.48306131831303,2,20.166926787582,4,35.6161297871808,8,1,"elevator",6,31.1330684688678
5.60672564430551,2,20.166926787582,4,42.6033693581772,10,1,"elevator",8,36.9966437138717
7.17921514612991,2,20.166926787582,4,30.3562848954264,7,1,"elevator",5,23.1770697492965
10.413262171404,2,20.166926787582,4,30.3562848954264,7,1,"elevator",5,19.9430227240224
0.0243922207706549,3,3.81852292663391,1,20.5020975052179,10,1,"elevator",7,20.4777052844472
0.775134981215546,3,3.81852292663391,1,17.4022437031394,9,1,"elevator",6,16.6271087219239
1.18482292124684,3,3.81852292663391,1,14.8478846226897,6,1,"elevator",3,13.6630617014429
1.62757828244009,3,3.81852292663391,1,20.5020975052179,10,1,"elevator",7,18.8745192227778
5.96966242884396,3,9.95411840669863,4,12.5831054341036,1,1,"elevator",2,6.61344300525964
6.92990387693614,3,21.3425154278874,4,42.6033693581772,10,1,"elevator",7,35.6734654812411
6.98020621153161,3,21.3425154278874,4,37.5352371841098,9,1,"elevator",6,30.5550309725782
8.12456340754495,3,21.3425154278874,4,30.3562848954264,7,1,"elevator",4,22.2317214878814
8.81684471566321,3,21.3425154278874,4,29.1872996265119,6,1,"elevator",3,20.3704549108487
9.04524096271865,3,21.3425154278874,4,42.6033693581772,10,1,"elevator",7,33.5581283954585
12.3478378534766,4,21.4372038040291,5,27.8223585438651,1,1,"elevator",3,15.4745206903885
12.7916968653428,4,23.7422341397181,4,35.6161297871808,8,1,"elevator",4,22.824432921838
12.9115674383266,4,21.4372038040291,5,27.8223585438651,1,1,"elevator",3,14.9107911055385
2.2773126900817,5,3,3,19.4065701009512,10,1,"elevator",5,17.1292574108695
3.20814013636361,5,4,4,12.5831054341036,1,1,"elevator",4,9.37496529773999
4.89515771974846,5,19.6609458493638,5,27.8223585438651,1,1,"elevator",4,22.9272008241166
11.5241521342955,6,12.2384885402451,2,23.8809041981436,10,1,"elevator",4,12.3567520638481
11.6100817873187,6,34,2,41.027227573695,3,1,"elevator",3,29.4171457863763
16.0865040014384,6,29.1872996265119,4,37.5352371841098,9,1,"elevator",3,21.4487331826714
0.484965266674344,7,29.3227526391461,1,45.8500100970634,1,1,"elevator",6,45.3650448303891
13.6025000015247,7,29.3227526391461,1,43.5245779305972,2,1,"elevator",5,29.9220779290725
14.8001739453497,7,29.3227526391461,1,35.1149283083769,4,1,"elevator",3,20.3147543630272
0.963834947906435,8,6.20510431641673,5,19.6609458493638,5,1,"elevator",3,18.6971109014574
3.16773113484184,8,6.20510431641673,5,19.6609458493638,5,1,"elevator",3,16.493214714522
8.26227938728341,8,25.7122924956149,3,42.4200484470853,3,1,"elevator",5,34.1577690598019
0.211414285370696,9,5.09902537597304,5,19.1592142335665,6,1,"elevator",3,18.9477999481958
4.16259247211419,9,5.09902537597304,5,24.3263260647553,3,1,"elevator",6,20.1637335926411
4.63060571284414,9,5.09902537597304,5,25.4919375584126,2,1,"elevator",7,20.8613318455685
2.19506576657295,10,24.405292688462,3,37.9577954808779,5,1,"elevator",5,35.7627297143049
8.95085521014341,10,24.405292688462,3,31.8743476071416,7,1,"elevator",3,22.9234923969982
9.13645786826122,10,24.405292688462,3,45.4068169140127,2,1,"elevator",8,36.2703590457515
0.0208727720045279,1,1,1,12.7619396540723,4,1,"elevator",3,12.7410668820678
3.02973242858765,1,31.779712159489,5,42.5543531700014,5,1,"elevator",4,39.5246207414137
4.48498878256738,1,30.441485859016,4,46.4612314011953,7,1,"elevator",6,41.9762426186279
4.60525104317539,1,31.779712159489,5,42.5543531700014,5,1,"elevator",4,37.949102126826
4.63863584918627,1,30.441485859016,4,46.4612314011953,7,1,"elevator",6,41.822595552009
5.1366751469458,1,30.441485859016,4,35.3151970970185,3,1,"elevator",2,30.1785219500727
5.20627130947732,1,31.779712159489,5,43.8803531775057,7,1,"elevator",6,38.6740818680284
5.98678483593835,1,30.441485859016,4,42.3549006759886,5,1,"elevator",4,36.3681158400503
8.69863433344351,1,30.441485859016,4,43.1990821925456,6,1,"elevator",5,34.5004478591021
8.91809910768705,1,31.779712159489,5,50.361918200521,9,1,"elevator",8,41.443819092834
0.934093723978823,2,1.84063961884792,1,12.7619396540723,4,1,"elevator",2,11.8278459300935
1.70508530915423,2,2.32214300049475,2,27.9033159884596,9,1,"elevator",7,26.1982306793054
2.72910349153146,2,32.4272821032166,3,64.3881050901141,10,1,"elevator",8,61.6590015985826
4.77169769703555,2,32.4272821032166,3,58.4511364795901,8,1,"elevator",6,53.6794387825545
6.2465337893938,2,32.4272821032166,3,55.7804608669674,7,1,"elevator",5,49.5339270775736
6.4020176824494,2,33.7745001232107,5,46.1354102014907,8,1,"elevator",6,39.7333925190413
6.55688782733213,2,32.4272821032166,3,64.3881050901141,10,1,"elevator",8,57.831217262782
9.11695809787854,2,32.4272821032166,3,42.5570908947661,4,1,"elevator",2,33.4401327968876
9.65877571501553,2,32.4272821032166,3,42.5570908947661,4,1,"elevator",2,32.8983151797506
10.1096705806886,2,33.7745001232107,5,46.1354102014907,8,1,"elevator",6,36.0257396208021
0.529884834308177,3,3.12645490008591,1,13.6702975389683,5,1,"elevator",2,13.1404127046601
2.36663604379612,3,3.12645490008591,1,24.4379223409597,8,1,"elevator",5,22.0712862971636
3.28555938914854,3,35.3151970970185,4,46.4612314011953,7,1,"elevator",4,43.1756720120468
4.06027915293407,3,38.1780741283042,3,58.4511364795901,8,1,"elevator",5,54.390857326656
5.10903231573803,3,35.3151970970185,4,55.6116696974423,10,1,"elevator",7,50.5026373817043
7.50620858580089,3,15.145517419563,5,16.9280082680734,1,1,"elevator",2,9.42179968227251
8.92596418370064,3,35.3151970970185,4,55.6116696974423,10,1,"elevator",7,46.6857055137417
9.46643352747466,3,38.1780741283042,3,55.7804608669674,7,1,"elevator",4,46.3140273394927
10.3239994229448,3,35.3151970970185,4,53.9672701382559,9,1,"elevator",6,43.6432707153111
10.5618840632587,3,35.3151970970185,4,43.1990821925456,6,1,"elevator",3,32.6371981292869
4.87395115168699,4,16.236793577185,2,21.7789889039254,7,1,"elevator",3,16.9050377522384
5.90998470423714,4,16.236793577185,2,21.4542512991744,6,1,"elevator",2,15.5442665949373
6.11771945637311,4,15.6762934672012,4,19.0738824925773,2,1,"elevator",2,12.9561630362042
1.51230789671298,5,2,4,6.34194596693642,9,1,"elevator",4,4.82963807022344
5.2045113567112,5,42.5543531700014,5,43.8803531775057,7,1,"elevator",2,38.6758418207945
9.88041436630278,5,19.8502704331373,2,27.9033159884596,9,1,"elevator",4,18.0229016221568
0.553676369599998,6,1.9431285886094,3,8.47717855612688,10,1,"elevator",4,7.92350218652688
6.97402959195831,6,14.7609413264797,4,19.0738824925773,2,1,"elevator",4,12.099852900619
12.492008061209,6,14.7609413264797,4,19.0738824925773,2,1,"elevator",4,6.5818744313683
3.3154268406173,7,13.1234129679579,4,19.0738824925773,2,1,"elevator",5,15.75845565196
6.91755484652177,7,42.1055367008575,1,52.3059538863378,10,1,"elevator",3,45.388399039816
9.8286177668478,7,20.7142546691443,3,27.3325533471804,2,1,"elevator",5,17.5039355803326
4.0292398474952,8,8.27845296554624,5,15.145517419563,3,1,"elevator",5,11.1162775720678
6.30205325768296,8,8.27845296554624,5,16.9280082680734,1,1,"elevator",7,10.6259550103904
7.52123700906489,8,8.27845296554624,5,15.8392262178058,2,1,"elevator",6,8.31798920874091
0.421068592307468,9,3.60142804339967,5,15.145517419563,3,1,"elevator",6,14.7244488272555
2.17978740731875,9,3.60142804339967,5,15.8392262178058,2,1,"elevator",7,13.659438810487
5.21742715796733,9,7,4,14.7609413264797,6,1,"elevator",3,9.54351416851237
4.77427120602934,10,14.4619691383928,3,19.0125200412209,8,1,"elevator",2,14.2382488351916
5.67066814518748,10,14.4619691383928,3,21.3160717000402,6,1,"elevator",4,15.6454035548527
7.6581691151289,10,14.4619691383928,3,23.6253602479971,4,1,"elevator",6,15.9671911328682
0.752411687704635,1,1,1,8.01560242300359,6,1,"elevator",5,7.26319073529896
1.24654548750715,1,2,2,27.1537929238567,10,1,"elevator",9,25.9072474363496
1.454364062171,1,2,2,10.3583530163606,3,1,"elevator",2,8.9039889541896
2.50891478623304,1,15.8181889845456,3,23.3577795783322,5,1,"elevator",4,20.8488647920992
3.22866760685948,1,15.8181889845456,3,26.1940024089,6,1,"elevator",5,22.9653348020405
3.41181382032197,1,15.8181889845456,3,21.7833273398172,3,1,"elevator",2,18.3715135194952
3.75951163152319,1,15.8181889845456,3,31.0027932367129,8,1,"elevator",7,27.2432816051897
4.41145648814824,1,15.8181889845456,3,31.0027932367129,8,1,"elevator",7,26.5913367485647
4.52229618722891,1,15.8181889845456,3,31.4591671416843,9,1,"elevator",8,26.9368709544554
4.82423288866691,1,15.8181889845456,3,23.3577795783322,5,1,"elevator",4,18.5335466896653
0.684774168301374,2,4.33977352519853,2,25.6724072052443,9,1,"elevator",7,24.9876330369429
1.85329539371179,2,4.33977352519853,2,15.1231848727842,5,1,"elevator",3,13.2698894790724
2.34949729214878,2,4.33977352519853,2,16.5486315314434,6,1,"elevator",4,14.1991342392946
2.49346649863768,2,4.33977352519853,2,27.1537929238567,10,1,"elevator",8,24.660326425219
3.03118556070153,2,4.33977352519853,2,27.1537929238567,10,1,"elevator",8,24.1226073631552
5.4305724374267,2,17.3008068545298,3,26.1940024089,6,1,"elevator",4,20.7634299714733
6.58262144521024,2,17.3008068545298,3,26.4238976871061,7,1,"elevator",5,19.8412762418959
8.48584647215097,2,17.3008068545298,3,26.1940024089,6,1,"elevator",4,17.708155936749
8.74404787150337,2,17.3008068545298,3,22.6966955380462,4,1,"elevator",2,13.9526476665428
10.1146567563026,2,17.3008068545298,3,26.4238976871061,7,1,"elevator",5,16.3092409308035
0.246241589597982,3,21.1058104422266,5,54.8779844258325,8,1,"elevator",5,54.6317428362345
1.34732863913708,3,21.7833273398172,3,26.1940024089,6,1,"elevator",3,24.8466737697629
6.18221836746097,3,21.1058104422266,5,47.9337983472498,7,1,"elevator",4,41.7515799797888
7.84271512262248,3,21.1058104422266,5,68.7179393351007,10,1,"elevator",7,60.8752242124782
9.55080344735697,3,21.7833273398172,3,23.3577795783322,5,1,"elevator",2,13.8069761309752
9.9202010941045,3,21.1058104422266,5,30.4010171805428,5,1,"elevator",2,20.4808160864383
10.3560769117722,3,21.1058104422266,5,54.8779844258325,8,1,"elevator",5,44.5219075140603
10.4587252361053,3,13.7509181913049,5,16.7562074713055,1,1,"elevator",2,6.2974822352002
10.7450169941695,3,13.7509181913049,5,16.7562074713055,1,1,"elevator",2,6.011190477136
11.7850022150068,3,21.1058104422266,5,68.7179393351007,10,1,"elevator",7,56.9329371200939
2.11022429168224,4,5.22116903955824,1,8.01560242300359,6,1,"elevator",2,5.90537813132135
5.87820189991001,4,29.2059738289778,5,64.1228515557843,9,1,"elevator",5,58.2446496558743
12.5844822478315,4,36.9566182137761,3,40.868061512744,2,1,"elevator",2,28.2835792649125
3.18052456828123,5,7.39484809332965,1,20.6101096288036,9,1,"elevator",4,17.4295850605224
7.15539930798679,5,23.3577795783322,3,31.0027932367129,8,1,"elevator",3,23.8473939287261
15.7156445618032,5,23.3577795783322,3,26.4238976871061,7,1,"elevator",2,10.7082531253029
0.92064575117704,6,6.99165371037612,5,11.5463685167223,4,1,"elevator",2,10.6257227655453
8.14149241307575,6,35.262577637946,2,41.0200759900936,2,1,"elevator",4,32.8785835770178
8.84047484059332,6,9.49568545784722,4,22.2542118832492,10,1,"elevator",4,13.4137370426559
0.435239310849783,7,6.27737765252197,5,13.7509181913049,3,1,"elevator",4,13.3156788804551
8.97494316509982,7,32.7044710599069,3,39.370781333815,3,1,"elevator",4,30.3958381687152
11.0308911925094,7,32.7044710599069,3,39.370781333815,3,1,"elevator",4,28.3398901413056
9.59084489993606,8,32.1229269579078,1,38.8864800926002,5,1,"elevator",3,29.2956351926641
12.7413753014133,8,32,3,40.868061512744,2,1,"elevator",6,28.1266862113307
18.4089903807647,8,19.9108140996435,1,22.5596652649547,10,1,"elevator",2,4.15067488419
0.185550573902826,9,1.10271280023867,5,6.27737765252197,7,1,"elevator",2,6.09182707861914
2.33685492072254,9,30.0055399561369,4,44.4048230083354,5,1,"elevator",4,42.0679680876129
2.71336841757937,9,30.0055399561369,4,53.5710042657882,1,1,"elevator",8,50.8576358482088
12.5683558166476,10,28.4300056874298,1,38.8864800926002,5,1,"elevator",5,26.3181242759526
15.0158885641367,10,28.4300056874298,1,38.8864800926002,5,1,"elevator",5,23.8705915284635
21.7543836143006,10,28.4300056874298,1,43.7520805930605,2,1,"elevator",8,21.9976969787599
0.523983996827155,1,1,1,26.9234763728764,10,1,"elevator",9,26.3994923760492
5.25753200075529,1,25.1866841789899,5,31.8858592918049,3,1,"elevator",2,26.6283272910496
6.11128591259117,1,25.1866841789899,5,40.3032109625913,7,1,"elevator",6,34.1919250500001
8.92932733313052,1,25.1866841789899,5,42.8183395925663,9,1,"elevator",8,33.8890122594358
8.97625721783248,1,25.1866841789899,5,35.2641452284228,5,1,"elevator",4,26.2878880105903
10.0034209785271,1,25.1866841789899,5,37.8643440262282,6,1,"elevator",5,27.8609230477011
10.0190920315615,1,25.1866841789899,5,33.6668976483479,4,1,"elevator",3,23.6478056167864
10.033023974922,1,25.1866841789899,5,31.8858592918049,3,1,"elevator",2,21.8528353168829
10.2296141721033,1,25.1866841789899,5,40.3032109625913,7,1,"elevator",6,30.073596790488
10.919409623342,1,25.1866841789899,5,31.8858592918049,3,1,"elevator",2,20.9664496684629
0.101232885848679,2,6.96029375298812,2,17.8614670968616,9,1,"elevator",7,17.7602342110129
4.63579084279882,2,6.96029375298812,2,24.1251902820887,10,1,"elevator",8,19.4893994392899
5.61113617389524,2,6.96029375298812,2,15.414922027692,7,1,"elevator",5,9.80378585379676
6.05622757023,2,33.1959210457027,4,47.2237466000043,10,1,"elevator",8,41.1675190297743
6.63499214110695,2,28.1369787777964,5,33.6668976483479,4,1,"elevator",2,27.0319055072409
6.83132558235227,2,28.1369787777964,5,44.2517676292672,10,1,"elevator",8,37.4204420469149
10.6280314446495,2,28.1369787777964,5,41.590144710822,8,1,"elevator",6,30.9621132661725
10.6580904283628,2,33.1959210457027,4,47.2237466000043,10,1,"elevator",8,36.5656561716415
10.6811133896343,2,28.1369787777964,5,33.6668976483479,4,1,"elevator",2,22.9857842587136
12.0298328681771,2,28.1369787777964,5,40.3032109625913,7,1,"elevator",5,28.2733780944142
1.45733310578773,3,6.53799992748822,1,18.1594385776657,7,1,"elevator",4,16.702105471878
2.12757247936363,3,6.53799992748822,1,26.9234763728764,10,1,"elevator",7,24.7959038935128
2.48905473638708,3,6.53799992748822,1,13.7368762135926,5,1,"elevator",2,11.2478214772055
3.38426794264372,3,6.53799992748822,1,26.9234763728764,10,1,"elevator",7,23.5392084302327
3.76575134660955,3,17.664359080765,4,21.9485622845752,1,1,"elevator",2,18.1828109379656
4.88675235769474,3,6.53799992748822,1,18.1594385776657,7,1,"elevator",4,13.272686219971
5.44435312737473,3,6.53799992748822,1,15.2926459130494,6,1,"elevator",3,9.84829278567467
5.47827621107285,3,6.53799992748822,1,13.7368762135926,5,1,"elevator",2,8.25860000251975
5.9592711271282,3,6.53799992748822,1,20.0501103111364,9,1,"elevator",6,14.0908391840082
8.71413600036674,3,31.8858592918049,5,37.8643440262282,6,1,"elevator",3,29.1502080258615
4.49510323180163,4,9.37181631201846,2,24.1251902820887,10,1,"elevator",6,19.6300870502871
10.9307528003575,4,11.110929737981,4,21.9485622845752,1,1,"elevator",3,11.0178094842177
12.2793980155906,4,29,3,39.5010149225125,8,1,"elevator",4,27.2216169069219
0.418696896854967,5,1,4,20.8908989493664,2,1,"elevator",3,20.4722020525114
3.84780599075851,5,13.1550429241073,2,24.1251902820887,10,1,"elevator",5,20.2773842913302
4.67034888104396,5,13.1550429241073,2,24.1251902820887,10,1,"elevator",5,19.4548414010447
0.238293995875072,6,2.01220028381795,3,7.7948694040197,10,1,"elevator",4,7.55657540814463
1.02735835870885,6,2.01220028381795,3,3.05602429513628,8,1,"elevator",2,2.02866593642743
7.3914072084257,6,14.7041973599063,2,15.6729620769615,8,1,"elevator",2,8.2815548685358
5.58756367621873,7,14.4196952008902,3,25.5473844495095,4,1,"elevator",3,19.9598207732908
6.24481352715678,7,14.4196952008902,3,25.5473844495095,4,1,"elevator",3,19.3025709223527
15.1751598778536,7,37,1,45.0434044272423,1,1,"elevator",6,29.8682445493887
1.38652167593439,8,2.5534196126365,5,10.8147545651067,4,1,"elevator",4,9.42823288917231
5.64931890913252,8,14.1368777318651,3,18.793064357215,5,1,"elevator",3,13.1437454480825
10.546147018458,8,14.1368777318651,3,17.3413705592653,6,1,"elevator",2,6.7952235408073
0.811460926197469,9,1.17535536549985,5,4.14093025018931,5,1,"elevator",4,3.32946932399184
9.38012370458263,9,12.4348413332964,3,14.4196952008902,7,1,"elevator",2,5.03957149630757
9.40767290783402,9,12.4348413332964,3,17.3413705592653,6,1,"elevator",3,7.93369765143128
1.11118267612677,10,11.0259182378905,3,18.793064357215,5,1,"elevator",5,17.6818816810882
11.4261976108174,10,26.2486058480542,2,37.847669074436,7,1,"elevator",3,26.4214714636186
15.4907174754948,10,26.2486058480542,2,49.717517821707,2,1,"elevator",8,34.2268003462122
1.50514677125298,1,2,2,17.8164875402546,7,1,"elevator",6,16.3113407690016
1.88205554963664,1,2,2,13.7904382857174,5,1,"elevator",4,11.9083827360808
3.08321817190485,1,20.4405709950229,3,33.5387647354438,5,1,"elevator",4,30.4555465635389
4.30252299424815,1,20.4405709950229,3,36.5973530721167,9,1,"elevator",8,32.2948300778685
4.65450681247372,1,40.457663800873,2,50.4073918946635,6,1,"elevator",5,45.7528850821898
6.54137611627182,1,20.4405709950229,3,36.5973530721167,9,1,"elevator",8,30.0559769558449
7.43531793992381,1,20.4405709950229,3,33.5387647354438,5,1,"elevator",4,26.10344679552
8.49978721528717,1,20.4405709950229,3,33.5387647354438,5,1,"elevator",4,25.0389775201566
8.90978353158973,1,20.4405709950229,3,34.5926048130045,7,1,"elevator",6,25.6828212814148
9.606578366467,1,20.4405709950229,3,21.616217427541,3,1,"elevator",2,12.009639061074
0.19016660874637,2,1.52191440947354,1,18.987093755413,10,1,"elevator",8,18.7969271466666
2.11196430409512,2,6.69529474220361,2,12.6070842291142,4,1,"elevator",2,10.4951199250191
2.45277293182113,2,6.69529474220361,2,17.8164875402546,7,1,"elevator",5,15.3637146084335
4.82009125457716,2,6.69529474220361,2,15.9476537434491,6,1,"elevator",4,11.1275624888719
5.22920511386928,2,6.69529474220361,2,17.8164875402546,7,1,"elevator",5,12.5872824263853
10.6329835343364,2,21.1240644158936,3,36.5973530721167,9,1,"elevator",7,25.9643695377803
11.855482841364,2,25.6733534033894,5,32.1481041873593,6,1,"elevator",4,20.2926213459953
12.4566147890751,2,21.1240644158936,3,38.8121670007592,10,1,"elevator",8,26.3555522116841
12.9194963397336,2,21.1240644158936,3,34.5926048130045,7,1,"elevator",5,21.6731084732709
14.5245502878881,2,21.1240644158936,3,36.5973530721167,9,1,"elevator",7,22.0728027842286
0.529808280058205,3,4.60990496512108,1,18.1592393518761,9,1,"elevator",6,17.6294310718179
1.97474211941461,3,4.60990496512108,1,13.9036866818271,8,1,"elevator",5,11.9289445624125
3.3550025375418,3,4.60990496512108,1,13.9036866818271,8,1,"elevator",5,10.5486841442853
4.36264527136428,3,21.616217427541,3,33.5387647354438,5,1,"elevator",2,29.1761194640795
5.62278743655844,3,21.616217427541,3,33.5387647354438,5,1,"elevator",2,27.9159772988854
6.77434602011874,3,26.9254011175148,5,35.0219167262262,8,1,"elevator",5,28.2475707061075
6.93132298471156,3,21.616217427541,3,38.8121670007592,10,1,"elevator",7,31.8808440160476
9.47048718687333,3,13.0699473217441,3,18.7668056798416,1,1,"elevator",2,9.29631849296827
9.92866581434804,3,21.616217427541,3,33.5387647354438,5,1,"elevator",2,23.6100989210958
12.0571686799413,3,26.9254011175148,5,32.1481041873593,6,1,"elevator",3,20.090935507418
8.87573688559445,4,27.4851390165761,5,35.0219167262262,8,1,"elevator",4,26.1461798406318
11.7311741999546,4,27.4851390165761,5,32.1481041873593,6,1,"elevator",2,20.4169299874047
13.2811814839526,4,27.4851390165761,5,32.1481041873593,6,1,"elevator",2,18.8669227034067
1.18788312965383,5,2,4,4.58338262536772,7,1,"elevator",2,3.39549949571389
3.0238879735892,5,8.30420452624803,3,13.0699473217441,3,1,"elevator",2,10.0460593481549
4.49886572392037,5,12.3253111587554,1,13.409282666789,7,1,"elevator",2,8.91041694286863
3.33335816846196,6,12.5773986444059,1,18.987093755413,10,1,"elevator",4,15.653735586951
3.75004231605335,6,12.5773986444059,1,18.1592393518761,9,1,"elevator",3,14.4091970358227
5.92841245840891,6,12.5773986444059,1,18.987093755413,10,1,"elevator",4,13.0586812970041
6.82303094587533,7,10.8178412771224,5,21.9607426938446,2,1,"elevator",5,15.1377117479693
7.6660017930275,7,10.8178412771224,5,21.9607426938446,2,1,"elevator",5,14.2947409008171
7.76919520715949,7,13.409282666789,1,18.1592393518761,9,1,"elevator",2,10.3900441447166
0.722357568839347,8,6.06680859021803,5,17.695969198463,4,1,"elevator",4,16.9736116296237
4.80114009030162,8,6.06680859021803,5,21.9607426938446,2,1,"elevator",6,17.159602603543
5.25842482643822,8,6.06680859021803,5,17.695969198463,4,1,"elevator",4,12.4375443720248
0.644093942828476,9,3.4147287531847,5,14.0712341057311,5,1,"elevator",4,13.4271401629026
18.2970789546279,9,21.4251878496373,4,40.7812216162182,1,1,"elevator",8,22.4841426615903
31.1864546448836,9,38.1241520593174,1,54.8238027633879,3,1,"elevator",6,23.6373481185043
1.22434337157756,10,18.6870491811181,4,35.3041287104641,3,1,"elevator",7,34.0797853388865
2.64834302787979,10,18.6870491811181,4,34.1256911822869,4,1,"elevator",6,31.4773481544071
7.30192499280386,10,18.6870491811181,4,40.7812216162182,1,1,"elevator",9,33.4792966234143
0.229469745885581,1,1,1,7.0416318237532,6,1,"elevator",5,6.81216207786762
0.656227224040776,1,1,1,3.22586831495092,3,1,"elevator",2,2.56964109091014
1.77247196850823,1,2,2,26.5497020073098,9,1,"elevator",8,24.7772300388016
2.77299865000861,1,22.2554970589475,4,55.6838777263491,10,1,"elevator",9,52.9108790763405
4.63887802727481,1,22.2554970589475,4,38.3499879816316,5,1,"elevator",4,33.7111099543568
4.97939111554955,1,22.2554970589475,4,54.1483292392065,9,1,"elevator",8,49.1689381236569
6.02533135448998,1,22.2554970589475,4,38.3499879816316,5,1,"elevator",4,32.3246566271416
6.10898775167248,1,22.2554970589475,4,35.0338141999007,3,1,"elevator",2,28.9248264482282
6.75579825953996,1,22.2554970589475,4,36.4587928038364,4,1,"elevator",3,29.7029945442964
7.26026920999816,1,22.2554970589475,4,36.4587928038364,4,1,"elevator",3,29.1985235938382
0.557701739482582,2,5.10166171718774,2,24.2651468073773,7,1,"elevator",5,23.7074450678947
4.98205965116484,2,5.10166171718774,2,14.3842199892735,5,1,"elevator",3,9.40216033810866
4.99445581672741,2,5.10166171718774,2,24.7082860143007,8,1,"elevator",6,19.7138301975733
5.99204447818472,2,22.0406771893922,3,36.9640787284368,6,1,"elevator",4,30.9720342502521
10.5621815204849,2,22.0406771893922,3,31.5379384652857,4,1,"elevator",2,20.9757569448008
11.5757309702965,2,22.0406771893922,3,39.9786305538558,10,1,"elevator",8,28.4028995835593
11.7833882240947,2,22.0406771893922,3,31.5379384652857,4,1,"elevator",2,19.754550241191
12.4288240020531,2,22.0406771893922,3,39.2165436978446,9,1,"elevator",7,26.7877196957915
17.378459136769,2,22.0406771893922,3,37.4704196313875,7,1,"elevator",5,20.0919604946185
17.6797869040852,2,22.0406771893922,3,34.7420495627601,5,1,"elevator",3,17.0622626586749
1.3234026999724,3,4.58566485802623,4,7.00204018215917,1,1,"elevator",2,5.67863748218677
1.38762223947997,3,3.22586831495092,1,14.2606617375218,9,1,"elevator",6,12.8730394980418
2.58036208841678,3,3.22586831495092,1,5.66481394283289,5,1,"elevator",2,3.08445185441611
3.53352267607299,3,7.0453464229071,2,24.2651468073773,7,1,"elevator",4,20.7316241313043
4.7602703183022,3,7.0453464229071,2,31.3924595383164,10,1,"elevator",7,26.6321892200142
6.78397180718989,3,7.0453464229071,2,24.7082860143007,8,1,"elevator",5,17.9243142071108
7.95626449414673,3,10.1153466263786,3,16.1408314446461,1,1,"elevator",2,8.18456695049937
8.25518775328207,3,10.1153466263786,3,16.1408314446461,1,1,"elevator",2,7.88564369136403
8.8066051597973,3,32.0016027547234,1,33.6207723319914,5,1,"elevator",2,24.8141671721941
8.93662422106468,3,32.0016027547234,1,33.6207723319914,5,1,"elevator",2,24.6841481109267
10.5351964130363,4,31.5379384652857,3,36.9640787284368,6,1,"elevator",2,26.4288823154005
15.6895735091992,4,31.5379384652857,3,37.4704196313875,7,1,"elevator",3,21.7808461221883
18.0010405162283,4,31.5379384652857,3,39.9786305538558,10,1,"elevator",6,21.9775900376275
11.4264265442254,5,33.6207723319914,1,39.7071530223333,8,1,"elevator",3,28.2807264781079
15.0022923535806,5,33.6207723319914,1,34.7368812996363,7,1,"elevator",2,19.7345889460557
21.0116200977447,5,25.6419323776614,1,31.9307284291343,2,1,"elevator",3,10.9191083313896
0.677316804509754,6,3.60416548304921,3,7.64075402501242,3,1,"elevator",3,6.96343722050267
2.59150013274838,6,7.0416318237532,1,12.8191704902356,8,1,"elevator",2,10.2276703574872
5.315431935424,6,21.8948121015147,1,27.4968475500002,4,1,"elevator",2,22.1814156145762
10.1725827896954,7,14.2495489887873,5,21.5800717227228,5,1,"elevator",2,11.4074889330274
10.9417195410765,7,14.2495489887873,5,25.9535721929237,4,1,"elevator",3,15.0118526518472
14.500488586955,7,21.6026366954392,1,25.6419323776614,5,1,"elevator",2,11.1414437907064
8.82743776423447,8,12.7662696253488,5,21.5800717227228,5,1,"elevator",3,12.7526339584883
9.05571752428914,8,12.7662696253488,5,31.5743297166472,1,1,"elevator",7,22.5186121923581
9.53026538302903,8,12.7662696253488,5,31.5743297166472,1,1,"elevator",7,22.0440643336182
1.71364137592415,9,9.67387645425266,5,31.5743297166472,1,1,"elevator",8,29.860688340723
5.01225423985128,9,9.67387645425266,5,28.7317059331774,2,1,"elevator",7,23.7194516933261
7.69148803908932,9,9.67387645425266,5,14.2495489887873,7,1,"elevator",2,6.55806094969798
1.07946600467131,10,2,5,17.1738379711254,6,1,"elevator",4,16.0943719664541
2.76134660480087,10,19.2629784896415,1,31.9307284291343,2,1,"elevator",8,29.1693818243334
9.96347202579555,10,19.2629784896415,1,21.8948121015147,6,1,"elevator",4,11.9313400757191
0.406079894863069,1,1,1,17.3896060172688,7,1,"elevator",6,16.9835261224057
1.87219533222708,1,2,2,26.150688150818,10,1,"elevator",9,24.2784928185909
2.11363326038072,1,11.2582218168588,4,32.5164888049719,8,1,"elevator",7,30.4028555445912
3.41813366135876,1,10,3,24.1522828499154,5,1,"elevator",4,20.7341491885566
3.60081580115776,1,11.2582218168588,4,33.9651342383289,9,1,"elevator",8,30.3643184371711
4.72267246914846,1,10,3,20.9175534096973,4,1,"elevator",3,16.1948809405488
5.60335270113652,1,11.2582218168588,4,20.1571660934756,3,1,"elevator",2,14.5538133923391
7.28618105849571,1,11.2582218168588,4,33.9651342383289,9,1,"elevator",8,26.6789531798332
8.68929653055181,1,11.2582218168588,4,31.6405466674111,7,1,"elevator",6,22.9512501368593
8.80039353388508,1,11.2582218168588,4,33.9651342383289,9,1,"elevator",8,25.1647407044438
0.256695441901684,2,6.16129350123887,2,11.4178268332718,5,1,"elevator",3,11.1611313913701
0.376832588248858,2,6.16129350123887,2,21.2431737765263,8,1,"elevator",6,20.8663411882774
1.43751385917974,2,6.16129350123887,2,16.8786239087287,7,1,"elevator",5,15.441110049549
2.42111564149137,2,6.16129350123887,2,16.8786239087287,7,1,"elevator",5,14.4575082672373
3.36722751144764,2,6.16129350123887,2,21.3575947577543,9,1,"elevator",7,17.9903672463067
3.45249927311096,2,6.16129350123887,2,12.9766249942814,6,1,"elevator",4,9.52412572117044
5.38198663180566,2,6.16129350123887,2,10.3904396718817,4,1,"elevator",2,5.00845304007604
10.4814869169731,2,14.7720588972735,3,29.1743603423608,8,1,"elevator",6,18.6928734253877
10.5805579963726,2,14.7720588972735,3,20.9175534096973,4,1,"elevator",2,10.3369954133247
12.0198610568395,2,14.7720588972735,3,24.1522828499154,5,1,"elevator",3,12.1324217930759
0.593870745506138,3,4.09477715395371,1,17.0854905663456,6,1,"elevator",3,16.4916198208395
3.71700307104697,3,4.09477715395371,1,17.3896060172688,7,1,"elevator",4,13.6726029462218
4.15503180149903,3,17.232286741935,3,25.8926397843333,6,1,"elevator",3,21.7376079828343
5.08252078972241,3,17.232286741935,3,32.79895576336,10,1,"elevator",7,27.7164349736376
5.50676693067208,3,17.232286741935,3,32.79895576336,10,1,"elevator",7,27.2921888326879
7.22648280123409,3,17.232286741935,3,25.8926397843333,6,1,"elevator",3,18.6661569830992
7.69802904511031,3,17.232286741935,3,32.79895576336,10,1,"elevator",7,25.1009267182497
8.61121021775214,3,17.232286741935,3,31.6849617643744,9,1,"elevator",6,23.0737515466223
8.89213236333487,3,17.232286741935,3,31.6849617643744,9,1,"elevator",6,22.7928294010395
8.98190256002549,3,17.232286741935,3,25.8926397843333,6,1,"elevator",3,16.9107372243078
1.95469996581475,4,10.3547459458969,1,26.6903864706097,10,1,"elevator",6,24.7356865047949
2.00276898064961,4,4.54933312293947,3,9.86281839309846,1,1,"elevator",3,7.86004941244885
2.93129108225306,4,4.54933312293947,3,8.52072473362674,2,1,"elevator",2,5.58943365137368
0.00408165001620849,5,1,4,4.92343713346733,1,1,"elevator",4,4.91935548345112
2.38018019576524,5,13.8623719770215,1,21.4279501331144,9,1,"elevator",4,19.0477699373492
4.49285635865881,5,13.8623719770215,1,19.7741497596403,8,1,"elevator",3,15.2812934009815
1.71295890118927,6,8.77035318551398,5,10.5996683291695,4,1,"elevator",2,8.88670942798023
5.35411353640324,6,8.77035318551398,5,18.8658919708424,1,1,"elevator",5,13.5117784344392
5.82702235021696,6,17.0854905663456,1,19.7741497596403,8,1,"elevator",2,13.9471274094233
3.78123220973615,7,16.8786239087287,2,26.150688150818,10,1,"elevator",3,22.3694559410818
4.62178926776555,7,7.94757654870674,5,10.5996683291695,4,1,"elevator",3,5.97787906140395
12.0290792529128,7,35.5900893220678,4,43.4532660596156,3,1,"elevator",4,31.4241868067028
4.29033178822104,8,6.65172561573609,5,18.8658919708424,1,1,"elevator",7,14.5755601826214
6.07504717525993,8,34.5373556396307,1,48.4701720317679,3,1,"elevator",5,42.395124856508
10.475713466014,8,34.5373556396307,1,46.2620480502109,5,1,"elevator",3,35.7863345841969
2.42984088713745,9,3.69391476727071,5,17.3659379339863,2,1,"elevator",7,14.9360970468488
7.53978693437884,9,31.2391168267599,1,41.0504300755473,6,1,"elevator",3,33.5106431411685
15.5620018470786,9,31.2391168267599,1,49.1282353103174,2,1,"elevator",7,33.5662334632388
3.18589692051405,10,33,3,53.4658084194214,1,1,"elevator",9,50.2799114989074
16.3791989439698,10,28.8353729748224,1,41.0504300755473,6,1,"elevator",4,24.6712311315775
18.3848198982176,10,28.8353729748224,1,34.5373556396307,8,1,"elevator",2,16.1525357414131
0.104765262271276,1,1,1,17.145517048123,8,1,"elevator",7,17.0407517858517
1.97875685590579,1,2,2,14.2779167737542,6,1,"elevator",5,12.2991599178484
4.30319349242138,1,22.8862257761659,4,36.7111699625619,9,1,"elevator",8,32.4079764701405
4.4300723193048,1,30.5679993711937,5,43.4951014089644,5,1,"elevator",4,39.0650290896596
4.62933350032523,1,22.8862257761659,4,36.7111699625619,9,1,"elevator",8,32.0818364622367
11.0239384045243,1,30.5679993711937,5,57.5061655142718,10,1,"elevator",9,46.4822271097475
11.5574590281002,1,22.8862257761659,4,36.7111699625619,9,1,"elevator",8,25.1537109344617
11.6833430567175,1,22.8862257761659,4,35.2161640303521,8,1,"elevator",7,23.5328209736346
12.0427575564362,1,22.8862257761659,4,31.8311071944149,6,1,"elevator",5,19.7883496379787
12.4884619271732,1,30.5679993711937,5,48.4617300959125,9,1,"elevator",8,35.9732681687393
3.5888545854607,2,5.64846798987291,1,11.5504064988944,4,1,"elevator",2,7.9615519134337
3.63864681745258,2,5.64846798987291,1,18.1245934195598,9,1,"elevator",7,14.4859466021072
3.92415052807269,2,5.64846798987291,1,17.145517048123,8,1,"elevator",6,13.2213665200503
4.17124216417952,2,5.64846798987291,1,15.0667865505899,7,1,"elevator",5,10.8955443864104
4.21123622360493,2,5.64846798987291,1,12.7561899057956,6,1,"elevator",4,8.54495368219067
4.51701552600402,2,5.64846798987291,1,17.145517048123,8,1,"elevator",6,12.628501522119
5.64035971824338,2,26.0069473212258,4,35.2161640303521,8,1,"elevator",6,29.5758043121087
7.82482714368724,2,32.4164395255653,5,57.5061655142718,10,1,"elevator",8,49.6813383705846
8.16447901696475,2,26.0069473212258,4,35.2161640303521,8,1,"elevator",6,27.0516850133873
8.62017931294205,2,26.0069473212258,4,35.2161640303521,8,1,"elevator",6,26.59598471741
4.07874849976456,3,11.4921555870795,4,16.1048654851974,1,1,"elevator",2,12.0261169854328
4.49097887591875,3,27.1003151605511,4,36.7111699625619,9,1,"elevator",6,32.2201910866431
4.60028353247564,3,36.8945447177837,5,57.5061655142718,10,1,"elevator",7,52.9058819817962
4.86733148067962,3,27.1003151605511,4,30.5671726082875,5,1,"elevator",2,25.6998411276079
6.74190323984934,3,27.1003151605511,4,31.8311071944149,6,1,"elevator",3,25.0892039545656
7.14603906697709,3,36.8945447177837,5,43.4951014089644,5,1,"elevator",2,36.3490623419873
7.22664847611565,3,27.1003151605511,4,31.8311071944149,6,1,"elevator",3,24.6044587182993
7.38415715997672,3,27.1003151605511,4,35.2161640303521,8,1,"elevator",5,27.8320068703754
8.16957676256996,3,27.1003151605511,4,36.7111699625619,9,1,"elevator",6,28.5415931999919
8.80612207329821,3,39,3,52.58527579387,9,1,"elevator",6,43.7791537205718
1.05808284599334,4,5.88884111477594,2,14.8742901348803,7,1,"elevator",3,13.816207288887
1.1359270910422,4,5.88884111477594,2,15.469553352858,8,1,"elevator",4,14.3336262618158
16.5709893024507,4,40,2,60.3281227468027,10,1,"elevator",6,43.757133444352
4.33796616245334,5,9.6897206976936,2,15.469553352858,8,1,"elevator",3,11.1315871904047
4.66944909295586,5,9.6897206976936,2,17.890985608532,10,1,"elevator",5,13.2215365155761
10.9828343110577,5,43.2903800174448,2,54.6083652332918,9,1,"elevator",4,43.6255309222341
3.51943965055947,6,10.4046218294436,5,15.4954808443519,4,1,"elevator",2,11.9760411937924
7.35391594441541,6,11.3101029356284,3,20.5589067675453,10,1,"elevator",4,13.2049908231299
8.53476454182587,6,11.3101029356284,3,16.9785559129475,8,1,"elevator",2,8.44379137112163
9.01925406687172,7,28.0724266304588,2,34.2871124501668,3,1,"elevator",4,25.2678583832951
30.4769682494884,7,33.9622310569531,1,36.507676071892,4,1,"elevator",3,6.0307078224036
32.6295616197938,7,45.0166312550588,1,47.6510932093414,10,1,"elevator",3,15.0215315895476
13.3065535804085,8,31.2217071070691,3,37.3831779905158,4,1,"elevator",4,24.0766244101073
13.5598327460837,8,29.7506408057663,1,37.7101214023953,1,1,"elevator",7,24.1502886563116
14.3059629334586,8,17.145517048123,1,21.6621979034013,10,1,"elevator",2,7.3562349699427
4.72474902634084,9,7.56046324070481,5,25.2492784698542,2,1,"elevator",7,20.5245294435134
6.37159966784725,9,7.56046324070481,5,13.6836212132557,5,1,"elevator",4,7.31202154540845
21.6239153298083,9,28.2388958568398,3,38.3665590296761,3,1,"elevator",6,16.7426436998678
5.01766168794839,10,24.8554027609989,3,33.2226432286656,6,1,"elevator",4,28.2049815407172
5.64304252282339,10,24.8554027609989,3,31.2217071070691,8,1,"elevator",2,25.5786645842457
7.95914804365697,10,24.8554027609989,3,31.2217071070691,8,1,"elevator",2,23.2625590634121
0.272599509241131,1,1,1,23.3273760766516,9,1,"elevator",8,23.0547765674105
0.273680146107522,1,1,1,11.7069269672234,5,1,"elevator",4,11.4332468211159
0.430894539383189,1,1,1,11.7069269672234,5,1,"elevator",4,11.2760324278402
0.659904305514828,1,1,1,15.121509554593,6,1,"elevator",5,14.4616052490782
3.1775094498635,1,18.2075700346172,5,19.3511164860126,3,1,"elevator",2,16.1736070361491
4.44294837436505,1,18.2075700346172,5,39.6151777886853,10,1,"elevator",9,35.1722294143202
5.662921649761,1,18.2075700346172,5,19.3511164860126,3,1,"elevator",2,13.6881948362516
6.07870091390209,1,18.2075700346172,5,35.9470332190399,7,1,"elevator",6,29.8683323051378
7.40833787415045,1,18.2075700346172,5,35.9470332190399,7,1,"elevator",6,28.5386953448895
9.36838868605753,1,18.2075700346172,5,35.9470332190399,7,1,"elevator",6,26.5786445329824
0.217095423924635,2,4.10338412161877,1,22.8260282319036,8,1,"elevator",6,22.608932807979
0.339864975617479,2,8.84611603584061,2,29.2653902388072,6,1,"elevator",4,28.9255252631897
0.749954416383581,2,4.10338412161877,1,22.8260282319036,8,1,"elevator",6,22.07607381552
0.809867968713033,2,4.10338412161877,1,22.8260282319036,8,1,"elevator",6,22.0161602631906
1.40740853867038,2,4.10338412161877,1,11.7069269672234,5,1,"elevator",3,10.299518428553
1.45028996088086,2,4.10338412161877,1,23.3273760766516,9,1,"elevator",7,21.8770861157707
1.836922163074,2,8.84611603584061,2,29.2653902388072,6,1,"elevator",4,27.4284680757332
2.63806089717638,2,4.10338412161877,1,28.022167543921,10,1,"elevator",8,25.3841066467446
5.67228604474779,2,8.84611603584061,2,14.3809145961283,4,1,"elevator",2,8.70862855138051
6.23608016496267,2,8.84611603584061,2,36.5244401993917,10,1,"elevator",8,30.288360034429
3.04466629011517,3,12.3668856239402,2,31.1257148318566,7,1,"elevator",4,28.0810485417414
3.57329374209007,3,4.91160323071521,1,28.022167543921,10,1,"elevator",7,24.4488738018309
5.10861913322411,3,11.9321657999241,5,15.4303228188334,1,1,"elevator",2,10.3217036856093
7.39901656293686,3,19.3511164860126,5,35.9470332190399,7,1,"elevator",4,28.548016656103
7.62310528577681,3,19.3511164860126,5,37.8679007087919,9,1,"elevator",6,30.2447954230151
8.29310602377545,3,12.3668856239402,2,16.537308839487,5,1,"elevator",2,8.24420281571155
8.32868635882775,3,12.3668856239402,2,16.537308839487,5,1,"elevator",2,8.20862248065925
8.61174565615695,3,12.3668856239402,2,16.537308839487,5,1,"elevator",2,7.92556318333005
11.517664489957,3,19.3511164860126,5,33.4299746971724,6,1,"elevator",3,21.9123102072154
11.5766869321026,3,39.3381983614834,4,48.5360637957608,8,1,"elevator",5,36.9593768636582
1.56902121690412,4,7.37747514528862,4,16.6590165154858,7,1,"elevator",3,15.0899952985817
7.76054325179822,4,14.3809145961283,2,31.1257148318566,7,1,"elevator",3,23.3651715800584
8.76792978782521,4,14.3809145961283,2,33.4851035227204,9,1,"elevator",5,24.7171737348952
3.41885806668206,5,10.7981275005311,4,17.2717998307268,8,1,"elevator",3,13.8529417640447
4.93292769403164,5,10.7981275005311,4,21.7049973588868,10,1,"elevator",5,16.7720696648552
7.66110934058045,5,10.7981275005311,4,16.6590165154858,7,1,"elevator",2,8.99790717490535
0.791958911015514,6,1.35092044528574,3,7.61191650845311,10,1,"elevator",4,6.8199575974376
6.19671301895802,6,27.0505561640729,3,41.0813622034975,3,1,"elevator",3,34.8846491845395
13.2208574805373,6,14.5343967676306,4,21.7049973588868,10,1,"elevator",4,8.4841398783495
0.494751797205028,7,2.83425616657559,5,3.83246895917545,5,1,"elevator",2,3.33771716197042
0.672778661510167,7,2.44558798913153,3,7.61191650845311,10,1,"elevator",3,6.93913784694294
10.6014591951142,7,16.6590165154858,4,20.5848307625356,9,1,"elevator",2,9.9833715674214
0.120555673105021,8,2.14434539337496,5,11.9321657999241,3,1,"elevator",5,11.8116101268191
6.14954870321411,8,21.029086103505,3,40.6471547283121,4,1,"elevator",4,34.497606025098
6.86861454240244,8,21.029086103505,3,43.709970743308,1,1,"elevator",7,36.8413562009056
0.17977986484766,9,1.40979400472715,5,11.9321657999241,3,1,"elevator",6,11.7523859350764
4.46067998482192,9,16.1388924289974,3,24.0441480736685,7,1,"elevator",2,19.5834680888466
5.23334712396963,9,16.1388924289974,3,24.0441480736685,7,1,"elevator",2,18.8108009496989
0.762836113572121,10,1,5,15.4303228188334,1,1,"elevator",9,14.6674867052613
13.4964306086751,10,23.0348048525036,4,28.8882118082955,7,1,"elevator",3,15.3917811996204
18.0728261692119,10,23.0348048525036,4,34.8547886631364,2,1,"elevator",8,16.7819624939245
1.18294740334208,1,2,2,21.2734684056818,10,1,"elevator",9,20.0905210023397
1.37997126284594,1,2,2,15.9974178944222,7,1,"elevator",6,14.6174466315763
2.09290688931074,1,17.3542874916563,4,33.8079497603334,6,1,"elevator",5,31.7150428710227
2.15360852870222,1,17.3542874916563,4,42.3996993697754,9,1,"elevator",8,40.2460908410732
2.58612055824201,1,17.3542874916563,4,27.7982836079002,4,1,"elevator",3,25.2121630496582
3.32766800216664,1,17.3542874916563,4,33.8079497603334,6,1,"elevator",5,30.4802817581668
6.0147723259195,1,17.3542874916563,4,40.5868482357577,8,1,"elevator",7,34.5720759098382
8.42754065435585,1,17.3542874916563,4,25.6788132001326,3,1,"elevator",2,17.2512725457768
9.59153970516948,1,17.3542874916563,4,42.9192745590609,10,1,"elevator",9,33.3277348538914
10.6248011509254,1,17.3542874916563,4,42.3996993697754,9,1,"elevator",8,31.77489821885
0.932573629501176,2,1.59455722384155,1,6.54002474918526,8,1,"elevator",6,5.60745111968408
2.33143701950524,2,20.7688026585821,4,42.9192745590609,10,1,"elevator",8,40.5878375395557
2.43480412709945,2,20.7688026585821,4,40.5868482357577,8,1,"elevator",6,38.1520441086583
2.54791040766471,2,20.7688026585821,4,42.9192745590609,10,1,"elevator",8,40.3713641513962
3.62519815887267,2,20.7688026585821,4,42.9192745590609,10,1,"elevator",8,39.2940764001882
4.23502328150848,2,20.7688026585821,4,33.8079497603334,6,1,"elevator",4,29.5729264788249
5.1899966932128,2,20.7688026585821,4,33.8079497603334,6,1,"elevator",4,28.6179530671206
7.84360706972792,2,20.7688026585821,4,33.8079497603334,6,1,"elevator",4,25.9643426906055
9.02510727545605,2,20.7688026585821,4,31.5012768679307,5,1,"elevator",3,22.4761695924746
9.05737994028614,2,20.7688026585821,4,27.7982836079002,4,1,"elevator",2,18.7409036676141
0.293009498450536,3,4.20533845964819,2,21.2734684056818,10,1,"elevator",7,20.9804589072313
0.784166084896404,3,4.20533845964819,2,15.2635196283753,6,1,"elevator",3,14.4793535434789
0.851793713991256,3,1.69983948759678,4,10.3232922572811,1,1,"elevator",2,9.47149854328984
1.40504895861513,3,4.20533845964819,2,15.9974178944222,7,1,"elevator",4,14.5923689358071
3.62520190840343,3,4.20533845964819,2,15.9974178944222,7,1,"elevator",4,12.3722159860188
3.81177433160821,3,32.6699293068236,5,38.0854591757988,1,1,"elevator",2,34.2736848441906
5.49720981103105,3,25.6788132001326,4,42.9192745590609,10,1,"elevator",7,37.4220647480299
6.61725993115647,3,25.6788132001326,4,40.5868482357577,8,1,"elevator",5,33.9695883046012
6.65270064898027,3,35,2,41.2064819803476,7,1,"elevator",4,34.5537813313673
8.12916421278151,3,25.6788132001326,4,42.3996993697754,9,1,"elevator",6,34.2705351569939
2.649483512947,4,4.87945967816722,1,17.8367025393489,9,1,"elevator",5,15.1872190264019
5.5576007934591,4,27.7982836079002,4,40.4640411152608,7,1,"elevator",3,34.9064403218017
5.75957204808104,4,27.7982836079002,4,40.4640411152608,7,1,"elevator",3,34.7044690671798
0.615182948430763,5,1,3,4.59549377097347,7,1,"elevator",2,3.98031082254271
0.834966872482625,5,1,4,1.69983948759678,3,1,"elevator",2,0.864872615114155
1.25983464127193,5,23.5667237589388,5,32.6699293068236,3,1,"elevator",2,31.4100946655517
0.84352700971067,6,1.70858034706314,3,10.5795439528905,8,1,"elevator",2,9.73601694317983
2.75933962780982,6,22.5981076531366,5,30.7877060088652,4,1,"elevator",2,28.0283663810554
3.63248077686876,6,22.5981076531366,5,35.885686671088,2,1,"elevator",4,32.2532058942192
1.2451483034293,7,4.59549377097347,3,19.7070576016919,10,1,"elevator",3,18.4619092982626
3.88548778710669,7,16.1453538130774,5,23.5667237589388,5,1,"elevator",2,19.6812359718321
10.3883675020408,7,16.1453538130774,5,35.885686671088,2,1,"elevator",5,25.4973191690472
5.48611389207223,8,23.6622188976035,1,29.9349656210925,5,1,"elevator",3,24.4488517290203
7.84228848814918,8,23.6622188976035,1,33.4188590459663,1,1,"elevator",7,25.5765705578171
9.96463603395922,8,27.4423689061874,2,31.3827373219577,5,1,"elevator",3,21.4181012879985
1.59996387162141,9,3.19703501417282,5,23.5667237589388,5,1,"elevator",4,21.9667598873174
2.35309320551645,9,3.19703501417282,5,38.0854591757988,1,1,"elevator",8,35.7323659702824
2.37831477125477,9,3.19703501417282,5,35.885686671088,2,1,"elevator",7,33.5073718998332
0.45663519607236,10,1,5,32.6699293068236,3,1,"elevator",7,32.2132941107512
1.87850315279017,10,23,2,31.3827373219577,5,1,"elevator",5,29.5042341691675
3.52200759574771,10,24.5090454793126,3,37.9870977168666,4,1,"elevator",6,34.4650901211189
1.06339151035519,1,2,2,8.13551991411471,3,1,"elevator",2,7.07212840375952
1.40980766243757,1,2,2,11.5864839810574,6,1,"elevator",5,10.1766763186198
4.71080120166248,1,23.5952138272788,4,41.8869036529207,7,1,"elevator",6,37.1761024512582
6.83998619382926,1,23.5952138272788,4,33.6937820893223,5,1,"elevator",4,26.853795895493
7.8524191620312,1,23.5952138272788,4,41.8869036529207,7,1,"elevator",6,34.0344844908895
9.23339625988792,1,23.5952138272788,4,33.6937820893223,5,1,"elevator",4,24.4603858294344
9.48102112309151,1,23.5952138272788,4,45.5906494997398,9,1,"elevator",8,36.1096283766483
9.70432985349633,1,23.5952138272788,4,33.6937820893223,5,1,"elevator",4,23.989452235826
10.3161698175509,1,23.5952138272788,4,41.8869036529207,7,1,"elevator",6,31.5707338353698
10.3226384847807,1,23.5952138272788,4,33.6937820893223,5,1,"elevator",4,23.3711436045416
0.974015208850515,2,1.29329533688724,1,16.4968294371003,8,1,"elevator",6,15.5228142282498
3.04009411564533,2,5.43935962448221,2,20.2436951172577,8,1,"elevator",6,17.2036010016124
3.07989626970578,2,5.43935962448221,2,20.2436951172577,8,1,"elevator",6,17.1637988475519
3.38465848971594,2,5.43935962448221,2,21.0543190916414,10,1,"elevator",8,17.6696606019255
5.03284563149741,2,25.0586400561847,4,48.1677744892529,10,1,"elevator",8,43.1349288577555
5.86193948925959,2,25.0586400561847,4,33.6937820893223,5,1,"elevator",3,27.8318426000627
6.86903837447065,2,25.0586400561847,4,33.6937820893223,5,1,"elevator",3,26.8247437148516
10.0401041443922,2,25.0586400561847,4,41.8869036529207,7,1,"elevator",5,31.8467995085285
11.7320526103112,2,25.0586400561847,4,41.8869036529207,7,1,"elevator",5,30.1548510426095
13.1432610088673,2,25.0586400561847,4,32.6212002150028,4,1,"elevator",2,19.4779392061355
0.15423442190513,3,3.03598562607283,1,10.3973043524911,6,1,"elevator",3,10.243069930586
0.446069592610002,3,3.03598562607283,1,19.497203423412,9,1,"elevator",6,19.051133830802
0.745194298680872,3,3.03598562607283,1,19.497203423412,9,1,"elevator",6,18.7520091247311
1.10934954146066,3,3.03598562607283,1,16.4968294371003,8,1,"elevator",5,15.3874798956396
2.47749867202381,3,3.03598562607283,1,16.4968294371003,8,1,"elevator",5,14.0193307650765
3.87742453903538,3,28.1287191223821,5,37.9145307906303,7,1,"elevator",4,34.0371062515949
3.93195748838525,3,28.1287191223821,5,35.0129078515149,6,1,"elevator",3,31.0809503631297
4.09458791228872,3,28.1287191223821,5,41.1604725223282,8,1,"elevator",5,37.0658846100395
4.62285391890373,3,28.1287191223821,5,42.5435329417875,10,1,"elevator",7,37.9206790228838
6.58892906725316,3,28.1287191223821,5,42.2219770049458,9,1,"elevator",6,35.6330479376926
0.150340055247621,4,2.78040330898239,4,6.35408412619309,2,1,"elevator",2,6.20374407094547
0.682587383136626,4,28.7081813958941,5,42.2219770049458,9,1,"elevator",5,41.5393896218092
0.907605985410064,4,2.78040330898239,4,6.35408412619309,2,1,"elevator",2,5.44647814078303
0.732478848658502,5,1,4,14.8293922093296,1,1,"elevator",4,14.0969133606711
1.75860271323472,5,3,3,9.84625507530254,10,1,"elevator",5,8.08765236206782
7.57790644780356,5,10.6401577309992,2,20.5425247439455,9,1,"elevator",4,12.9646182961419
4.54578701082273,6,16.0554436975949,5,25.9641037412183,1,1,"elevator",5,21.4183167303956
7.66490691623894,6,16.0554436975949,5,25.9641037412183,1,1,"elevator",5,18.2991968249794
8.36989765958794,6,11.5864839810574,2,20.2436951172577,8,1,"elevator",2,11.8737974576698
2.00381102195631,7,23.7195066437689,3,34.6866565941427,3,1,"elevator",4,32.6828455721864
2.46712596931805,7,23.7195066437689,3,36.972931919048,1,1,"elevator",6,34.50580594973
3.48439941271181,7,23.7195066437689,3,36.972931919048,1,1,"elevator",6,33.4885325063362
3.91938103286837,8,9.36039961114446,5,21.1422507819498,3,1,"elevator",5,17.2228697490814
4.27481644089932,8,9.36039961114446,5,25.9641037412183,1,1,"elevator",7,21.689287300319
6.35041576113219,8,9.36039961114446,5,16.0554436975949,6,1,"elevator",2,9.70502793646271
1.62148547358811,9,6.50546973545976,5,25.9641037412183,1,1,"elevator",8,24.3426182676302
2.31231871983782,9,6.50546973545976,5,16.0554436975949,6,1,"elevator",3,13.7431249777571
4.57580080402519,9,6.50546973545976,5,20.4502050059041,4,1,"elevator",5,15.8744042018789
2.61323497848214,10,14.853873826251,3,23.7195066437689,7,1,"elevator",3,21.1062716652868
3.30023089020452,10,14.853873826251,3,23.7195066437689,7,1,"elevator",3,20.4192757535644
15.1341626648203,10,22,2,33.3953888459303,6,1,"elevator",4,18.26122618111
2.66949248860095,1,3,2,23.5843268883901,8,1,"elevator",7,20.9148343997892
3.710801990052,1,14.0493517180454,4,45.1208694532804,7,1,"elevator",6,41.4100674632284
4.16011638409135,1,14.0493517180454,4,56.5529859894879,10,1,"elevator",9,52.3928696053965
7.1633870621455,1,14.0493517180454,4,43.7169730317865,6,1,"elevator",5,36.553585969641
7.8890065160403,1,14.0493517180454,4,56.5529859894879,10,1,"elevator",9,48.6639794734476
8.19880774950702,1,14.0493517180454,4,46.901814269001,8,1,"elevator",7,38.703006519494
8.33526774782781,1,14.0493517180454,4,39.7588608122671,5,1,"elevator",4,31.4235930644393
8.76260140918288,1,14.0493517180454,4,56.5529859894879,10,1,"elevator",9,47.790384580305
9.46533758382862,1,14.0493517180454,4,39.7588608122671,5,1,"elevator",4,30.2935232284385
9.66607071788599,1,14.0493517180454,4,46.901814269001,8,1,"elevator",7,37.235743551115
1.45308650232831,2,9.19499228691447,2,16.9893578237199,4,1,"elevator",2,15.5362713213916
2.96883599399549,2,9.19499228691447,2,16.9893578237199,4,1,"elevator",2,14.0205218297244
3.34744914793369,2,9.19499228691447,2,23.5843268883901,8,1,"elevator",6,20.2368777404564
3.9034799312703,2,5,1,16.3755291460532,5,1,"elevator",3,12.4720492147829
4.93734352671693,2,5,1,29.2491896334121,10,1,"elevator",8,24.3118461066952
7.15611062353069,2,9.19499228691447,2,31.5567880487463,10,1,"elevator",8,24.4006774252156
8.05639120134181,2,9.19499228691447,2,22.4659518180362,7,1,"elevator",5,14.4095606166944
12.1789078686021,2,21.6307895011736,4,46.901814269001,8,1,"elevator",6,34.7229064003989
12.4096903788492,2,21.6307895011736,4,25.5580234495485,4,1,"elevator",2,13.1483330706993
13.8075328064808,2,21.6307895011736,4,39.7588608122671,5,1,"elevator",3,25.9513280057863
0.531016607426147,3,4.48645168666595,4,8.99095838838084,1,1,"elevator",2,8.45994178095469
5.16528371755164,3,11.2891589834267,5,19.944101282171,1,1,"elevator",2,14.7788175646194
5.44906662376444,3,7.76490459657254,1,25.9258365302734,8,1,"elevator",5,20.476769906509
5.9362309074014,3,11.2891589834267,5,19.944101282171,1,1,"elevator",2,14.0078703747696
6.78535632185732,3,11.2891589834267,5,19.944101282171,1,1,"elevator",2,13.1587449603137
7.52603749882048,3,22.3517186576129,4,39.7588608122671,5,1,"elevator",2,32.2328233134466
7.69769230762115,3,22.3517186576129,4,43.7169730317865,6,1,"elevator",3,36.0192807241654
7.70003243533512,3,22.3517186576129,4,43.7169730317865,6,1,"elevator",3,36.0169405964514
8.50883732862993,3,11.2891589834267,5,19.944101282171,1,1,"elevator",2,11.4352639535411
8.91369654031485,3,22.3517186576129,4,56.5529859894879,10,1,"elevator",7,47.639289449173
7.64135877952626,4,8.78123883289501,5,12.91113991985,2,1,"elevator",2,5.26978114032374
12.0257551784471,4,30.8405344982978,5,40.7096357721798,2,1,"elevator",2,28.6838805937327
14.5478963136679,4,30.8405344982978,5,40.7096357721798,2,1,"elevator",2,26.1617394585119
0.78705421693839,5,1,3,7.12785414568305,8,1,"elevator",3,6.34079992874466
9.38407892722941,5,16.3755291460532,1,29.2491896334121,10,1,"elevator",5,19.8651107061827
9.86270494344639,5,16.3755291460532,1,28.1607395640122,9,1,"elevator",4,18.2980346205658
2.10764344626417,6,20.5921102988739,1,29.2491896334121,10,1,"elevator",4,27.1415461871479
7.58310179097557,6,20.5921102988739,1,29.2491896334121,10,1,"elevator",4,21.6660878424365
10.8146936897835,6,31.8161073984843,3,41.6922669871299,2,1,"elevator",4,30.8775732973464
0.189302828996413,7,6.02274326365462,5,12.91113991985,2,1,"elevator",5,12.7218370908536
9.36257106355444,7,30.410178047617,3,36.0707753364073,5,1,"elevator",2,26.7082042728529
9.76204252284383,7,30.410178047617,3,43.661460295078,1,1,"elevator",6,33.8994177722342
1.61516910263648,8,4.63984483084662,5,6.96506444849095,6,1,"elevator",2,5.34989534585447
5.15011952399864,8,21.7433359369042,3,36.0707753364073,5,1,"elevator",3,30.9206558124087
6.19519171446218,8,21.7433359369042,3,41.6922669871299,2,1,"elevator",6,35.4970752726677
3.35725401514477,9,19.7128754899152,3,36.0707753364073,5,1,"elevator",4,32.7135213212625
8.02909657627855,9,19.7128754899152,3,37.6900960958755,4,1,"elevator",5,29.6609995195969
8.10247194445893,9,19.7128754899152,3,41.6922669871299,2,1,"elevator",7,33.589795042671
0.912721207826259,10,1,5,4.63984483084662,8,1,"elevator",2,3.72712362302036
3.11859694417707,10,16.6083627208511,3,38.349013530552,3,1,"elevator",7,35.2304165863749
8.33170410523763,10,16.6083627208511,3,30.410178047617,7,1,"elevator",3,22.0784739423794
5.41244833328226,1,29.2080097208617,4,52.7466688043566,10,1,"elevator",9,47.3342204710743
5.41604354659774,1,29.2080097208617,4,36.8673718498777,4,1,"elevator",3,31.45132830328
5.84654945562341,1,29.2080097208617,4,37.9041616918276,5,1,"elevator",4,32.0576122362042
5.86090642315083,1,29.2080097208617,4,52.7466688043566,10,1,"elevator",9,46.8857623812058
5.96648770387444,1,29.2080097208617,4,39.0806068351345,6,1,"elevator",5,33.1141191312601
6.33718974844712,1,29.2080097208617,4,52.7466688043566,10,1,"elevator",9,46.4094790559095
9.15528230830625,1,29.2080097208617,4,36.8673718498777,4,1,"elevator",3,27.7120895415715
9.66747987266228,1,29.2080097208617,4,47.4415989407659,9,1,"elevator",8,37.7741190681036
9.97825445789441,1,29.2080097208617,4,34.3705567942451,3,1,"elevator",2,24.3923023363507
11.1486700222926,1,29.2080097208617,4,47.4415989407659,9,1,"elevator",8,36.2929289184733
0.652235292384537,2,1.59312994452471,1,19.7222707497223,10,1,"elevator",8,19.0700354573378
1.51912196304373,2,5.76077265206107,2,24.9218592412691,8,1,"elevator",6,23.4027372782254
1.78646187156163,2,5.76077265206107,2,30.8010694043885,10,1,"elevator",8,29.0146075328269
4.43016554260786,2,5.76077265206107,2,14.1870108135077,5,1,"elevator",3,9.75684527089984
5.27348476955351,2,29.988680880861,4,39.0806068351345,6,1,"elevator",4,33.807122065581
5.331927105595,2,29.988680880861,4,36.8673718498777,4,1,"elevator",2,31.5354447442827
7.23051069649532,2,29.988680880861,4,52.7466688043566,10,1,"elevator",8,45.5161581078613
8.23424566691861,2,32.1852261192398,5,55.2136477218341,10,1,"elevator",8,46.9794020549155
9.27911876385676,2,29.988680880861,4,36.8673718498777,4,1,"elevator",2,27.5882530860209
9.36626739323349,2,29.988680880861,4,37.9041616918276,5,1,"elevator",3,28.5378942985941
0.82451858274163,3,3.94488908089262,1,14.6830328072234,8,1,"elevator",5,13.8585142244818
1.00461215475099,3,3.94488908089262,1,7.05987476547745,5,1,"elevator",2,6.05526261072646
1.38986377793625,3,3.94488908089262,1,13.2891062462747,7,1,"elevator",4,11.8992424683384
1.55886375208646,3,3.94488908089262,1,11.0999935819906,6,1,"elevator",3,9.54112982990414
3.17725101123488,3,9.19038680267906,2,14.1870108135077,5,1,"elevator",2,11.0097598022728
3.47868028339854,3,9.19038680267906,2,30.8010694043885,10,1,"elevator",7,27.32238912099
3.95204181280843,3,9.19038680267906,2,18.9868262138096,7,1,"elevator",4,15.0347844010012
6.64668382562126,3,9.19038680267906,2,14.1870108135077,5,1,"elevator",2,7.54032698788644
6.85329613645921,3,13.901788312401,4,17.0259900185806,1,1,"elevator",2,10.1726938821214
9.10990935363515,3,35.005368482697,5,53.47921190426,9,1,"elevator",6,44.3693025506249
9.00069870633594,4,40.8673679344654,5,53.47921190426,9,1,"elevator",5,44.4785131979241
12.5032876333209,4,36.8673718498777,4,39.0806068351345,6,1,"elevator",2,26.5773192018136
15.7597365254364,4,40.8673679344654,5,46.8881953367488,7,1,"elevator",3,31.1284588113124
0.325429692553977,5,1,3,6.67463262474779,7,1,"elevator",2,6.34920293219381
2.89979512944474,5,4,4,14.593240609212,2,1,"elevator",3,11.6934454797673
7.58835004445376,5,37.9041616918276,4,47.4415989407659,9,1,"elevator",4,39.8532488963121
0.81114331415544,6,4.80384814218669,3,12.4347783292538,9,1,"elevator",3,11.6236350150984
2.91905390719573,6,4.80384814218669,3,13.0633812952197,10,1,"elevator",4,10.144327388024
5.00476844608784,6,11.0999935819906,1,15.9825267393311,9,1,"elevator",3,10.9777582932433
4.72227388344018,7,14.523906053266,5,19.2667897872705,5,1,"elevator",2,14.5445159038303
7.3697433119785,7,14.523906053266,5,28.81748032531,2,1,"elevator",5,21.4477370133315
7.56264597135496,7,14.523906053266,5,29.6567284400808,1,1,"elevator",6,22.0940824687258
3.27506838706609,8,12.238567820575,5,29.6567284400808,1,1,"elevator",7,26.3816600530147
3.72464485153302,8,7.66567341531794,3,13.0633812952197,10,1,"elevator",2,9.33873644368668
8.82820779737386,8,12.238567820575,5,29.6567284400808,1,1,"elevator",7,20.8285206427069
2.3679643961132,9,7.06152800820418,5,14.523906053266,7,1,"elevator",2,12.1559416571528
5.17790866056391,9,7.06152800820418,5,28.81748032531,2,1,"elevator",7,23.6395716647461
16.9720235545065,9,21.7719450620948,3,36.5425586324565,4,1,"elevator",5,19.57053507795
0.570074231490302,10,1,5,28.81748032531,2,1,"elevator",8,28.2474060938197
5.07705162743613,10,17.6659657381067,3,40.6113284258892,2,1,"elevator",8,35.5342767984531
8.45242578055252,10,17.6659657381067,3,38.0863952427619,3,1,"elevator",7,29.6339694622094
0.833716561975789,1,1,1,20.1622755838687,9,1,"elevator",8,19.3285590218929
0.894966236275381,1,1,1,5.18720781200017,3,1,"elevator",2,4.29224157572479
5.83122185677382,1,15.0954266818394,4,19.493647420441,4,1,"elevator",3,13.6624255636672
6.73636888950936,1,15.0954266818394,4,20.2205086919655,5,1,"elevator",4,13.4841398024561
11.2210074200183,1,15.0954266818394,4,20.2205086919655,5,1,"elevator",4,8.9995012719472
11.4465877682144,1,15.0954266818394,4,32.9850250091764,9,1,"elevator",8,21.538437240962
13.2439905393966,1,15.0954266818394,4,19.493647420441,4,1,"elevator",3,6.2496568810444
13.2824543261066,1,15.0954266818394,4,32.9850250091764,9,1,"elevator",8,19.7025706830698
14.0637476657062,1,15.0954266818394,4,32.9850250091764,9,1,"elevator",8,18.9212773434702
14.4942228098876,1,15.0954266818394,4,16.8586372541225,3,1,"elevator",2,2.3644144442349
0.0232994565740228,2,2.48174730688334,2,19.4557549311509,8,1,"elevator",6,19.4324554745769
0.367669525090605,2,3.79246748413306,1,11.6467652798876,6,1,"elevator",4,11.279095754797
0.915095323696733,2,3.79246748413306,1,8.90855510220993,5,1,"elevator",3,7.9934597785132
2.90483652605655,2,3.79246748413306,1,11.6467652798876,6,1,"elevator",4,8.74192875383105
3.72990316270897,2,16.342462368911,4,20.2205086919655,5,1,"elevator",3,16.4906055292565
6.26734411635918,2,16.342462368911,4,20.2205086919655,5,1,"elevator",3,13.9531645756063
6.88048749522788,2,16.342462368911,4,24.2444152912017,6,1,"elevator",4,17.3639277959738
7.76543033257192,2,16.342462368911,4,19.493647420441,4,1,"elevator",2,11.7282170878691
11.1710907679612,2,16.342462368911,4,32.9850250091764,9,1,"elevator",7,21.8139342412152
13.6378148786025,2,16.342462368911,4,27.2406480638973,7,1,"elevator",5,13.6028331852948
0.175217626265107,3,2.24439715291549,4,5.90473282807835,1,1,"elevator",2,5.72951520181324
0.380443276708124,3,7.02540515026018,2,19.4557549311509,8,1,"elevator",5,19.0753116544428
3.28085735270697,3,11.7385696156693,3,15.6990135038887,1,1,"elevator",2,12.4181561511817
6.09009463701673,3,7.02540515026018,2,14.3134099288074,6,1,"elevator",3,8.22331529179067
6.41391676343389,3,7.02540515026018,2,14.3134099288074,6,1,"elevator",3,7.89949316537351
9.36667057451781,3,16.8586372541225,4,38.0805075776171,10,1,"elevator",7,28.7138370030993
11.7634711240926,3,16.8586372541225,4,30.7778596760107,8,1,"elevator",5,19.0143885519181
12.8320431795991,3,16.8586372541225,4,24.2444152912017,6,1,"elevator",3,11.4123721116026
15.7638017471219,3,22.846801967783,3,36.4001627841125,10,1,"elevator",7,20.6363610369906
15.9988311465169,3,16.8586372541225,4,27.2406480638973,7,1,"elevator",4,11.2418169173804
0.581561694853008,4,7.52876115082734,1,11.6467652798876,6,1,"elevator",2,11.0652035850346
7.19914779815136,4,10.3897007437787,2,14.7320780374619,7,1,"elevator",3,7.53293023931054
11.2842231901463,4,19.493647420441,4,38.0805075776171,10,1,"elevator",6,26.7962843874708
4.56137198009495,5,11.5758018108941,2,22.2566829026841,10,1,"elevator",5,17.6953109225892
5.12725003390473,5,10.9707957989813,3,13.6567063192283,2,1,"elevator",3,8.52945628532357
7.36338830724569,5,11.5758018108941,2,22.2566829026841,10,1,"elevator",5,14.8932945954384
2.11756428548445,6,28.4806436636287,2,31.6322414608106,4,1,"elevator",2,29.5146771753261
5.04179310815686,6,11.6467652798876,1,17.4083476451451,8,1,"elevator",2,12.3665545369882
5.48103606003924,6,28.4806436636287,2,35.0763259519673,3,1,"elevator",3,29.5952898919281
0.996460376427261,7,8.94428821642768,5,20.5149982541568,1,1,"elevator",6,19.5185378777295
1.23309451343609,7,8.94428821642768,5,17.2855595765603,2,1,"elevator",5,16.0524650631242
1.91185202793025,7,8.94428821642768,5,20.5149982541568,1,1,"elevator",6,18.6031462262265
8.6473337494603,8,19.4557549311509,2,22.2566829026841,10,1,"elevator",2,13.6093491532238
12.1815584269103,8,23.6199824670499,1,34.881694326448,1,1,"elevator",7,22.7001358995377
13.3003780815191,8,23.6199824670499,1,31.2749564004675,4,1,"elevator",4,17.9745783189484
10.1700017278442,9,22.969190128537,1,29.3891948539741,6,1,"elevator",3,19.2191931261299
13.7888147343417,9,22.969190128537,1,33.2307745015562,3,1,"elevator",6,19.4419597672145
18.0698052733203,9,22.969190128537,1,34.881694326448,1,1,"elevator",8,16.8118890531277
0.188027736181851,10,1,5,17.2855595765603,2,1,"elevator",8,17.0975318403784
0.627288304030732,10,1,5,13.8617176902214,5,1,"elevator",5,13.2344293861907
4.94732916751889,10,24.1387733380474,2,35.0763259519673,3,1,"elevator",7,30.1289967844484
1.57883597529473,1,2,2,13.7016719825003,4,1,"elevator",3,12.1228360072056
4.93328357203372,1,9.71526215491953,4,24.8801397542064,7,1,"elevator",6,19.9468561821727
4.94319859667644,1,9.71526215491953,4,26.9010057134924,8,1,"elevator",7,21.957807116816
5.23114412100017,1,9.71526215491953,4,28.7976274811419,9,1,"elevator",8,23.5664833601417
5.69915798081979,1,9.71526215491953,4,21.2158450988499,6,1,"elevator",5,15.5166871180301
6.1408419349134,1,9.71526215491953,4,32.6483450923025,10,1,"elevator",9,26.5075031573891
6.99537469450803,1,9.71526215491953,4,32.6483450923025,10,1,"elevator",9,25.6529703977945
8.43135814736996,1,9.71526215491953,4,17.676778909872,3,1,"elevator",2,9.24542076250204
9.4678557206962,1,27.2539340384956,5,39.815697626044,7,1,"elevator",6,30.3478419053478
12.4817487819708,1,27.2539340384956,5,29.9414090396364,3,1,"elevator",2,17.4596602576656
0.542860847432166,2,1.42364723328501,1,2.92334767153131,4,1,"elevator",2,2.38048682409914
0.925094637088478,2,1.42364723328501,1,16.78675603755,10,1,"elevator",8,15.8616614004615
0.970829335952687,2,1.42364723328501,1,16.78675603755,10,1,"elevator",8,15.8159267015973
1.44652175621926,2,11.3761446146841,2,15.9975149633823,5,1,"elevator",3,14.550993207163
2.0068931267397,2,11.3761446146841,2,18.9674895530518,8,1,"elevator",6,16.9605964263121
3.61935822515593,2,11.3761446146841,2,18.9674895530518,8,1,"elevator",6,15.3481313278959
3.87946000755529,2,11.3761446146841,2,18.2530187500512,6,1,"elevator",4,14.3735587424959
4.17474997802402,2,11.3761446146841,2,15.9975149633823,5,1,"elevator",3,11.8227649853583
4.75471483277852,2,11.3761446146841,2,15.9975149633823,5,1,"elevator",3,11.2428001306038
5.84944733281842,2,11.3761446146841,2,22.5495421612383,9,1,"elevator",7,16.7000948284199
0.116478958638015,3,3.3822347384015,4,7.81761180421931,1,1,"elevator",2,7.7011328455813
2.08773841095659,3,3.3822347384015,4,7.81761180421931,1,1,"elevator",2,5.72987339326272
3.08532082137678,3,13.2286391852792,2,18.9674895530518,8,1,"elevator",5,15.882168731675
4.50266090883957,3,17.676778909872,4,26.9010057134924,8,1,"elevator",5,22.3983448046528
5.14895137968557,3,19.8621518839676,5,24.9734714670758,1,1,"elevator",2,19.8245200873902
5.97482902655917,3,19.8621518839676,5,24.9734714670758,1,1,"elevator",2,18.9986424405166
6.29457639582994,3,13.2286391852792,2,25.6009381939686,10,1,"elevator",7,19.3063617981387
6.48043203732538,3,13.2286391852792,2,15.9975149633823,5,1,"elevator",2,9.51708292605692
6.81301172316614,3,13.2286391852792,2,22.5495421612383,9,1,"elevator",6,15.7365304380722
6.84625255327999,3,13.2286391852792,2,18.9674895530518,8,1,"elevator",5,12.1212369997718
5.6926278477786,4,19.4545315962196,4,32.6483450923025,10,1,"elevator",6,26.9557172445239
8.10374268948246,4,31.9011529334117,5,39.815697626044,7,1,"elevator",3,31.7119549365615
8.12691722062943,4,13.7016719825003,2,22.5495421612383,9,1,"elevator",5,14.4226249406089
0.351555485588809,5,1,4,3.3822347384015,3,1,"elevator",2,3.03067925281269
2.30989303439856,5,15.3226767114535,5,19.8621518839676,3,1,"elevator",2,17.552258849569
20.6027553655339,5,22.0302879138269,3,26.5092983896404,3,1,"elevator",2,5.9065430241065
0.947590403569241,6,2.17617127299309,3,6.74419666601732,8,1,"elevator",2,5.79660626244808
1.51630213794609,6,2.17617127299309,3,10.3973809397387,10,1,"elevator",4,8.88107880179261
11.7423849392048,6,23.2654386286611,1,30.1799684133326,1,1,"elevator",5,18.4375834741278
1.71647812550267,7,8.19537505108215,5,22.4762684630138,2,1,"elevator",5,20.7597903375111
3.26125829635809,7,8.19537505108215,5,16.8345294519205,4,1,"elevator",3,13.5732711555624
13.094943976423,7,20.4190861287412,3,30.8644331568929,1,1,"elevator",6,17.7694891804699
0.214983405651803,8,6.74419666601732,3,10.3973809397387,10,1,"elevator",2,10.1823975340869
10.6764245842082,8,11.616121462202,1,16.78675603755,10,1,"elevator",2,6.1103314533418
17.0110082749391,8,20.9562832774876,1,23.2654386286611,6,1,"elevator",2,6.254430353722
0.9595432303225,9,6.62298545699011,5,24.9734714670758,1,1,"elevator",8,24.0139282367533
3.40240265248419,9,6.62298545699011,5,15.3226767114535,5,1,"elevator",4,11.9202740589693
5.37731582459759,9,6.62298545699011,5,15.3226767114535,5,1,"elevator",4,9.94536088685591
2.64647408995434,10,12.5544231783907,3,29.6691050569359,2,1,"elevator",8,27.0226309669816
3.14169322126512,10,12.5544231783907,3,30.8644331568929,1,1,"elevator",9,27.7227399356278
4.41078976248358,10,12.5544231783907,3,15.0172604203998,8,1,"elevator",2,10.6064706579162
0.123832949902862,1,1,1,14.9015450151596,6,1,"elevator",5,14.7777120652567
0.746200105641037,1,1,1,22.845130595635,9,1,"elevator",8,22.098930489994
0.850854525342584,1,3.56633444401416,2,16.4122581037181,7,1,"elevator",6,15.5614035783755
1.28201221395284,1,3.56633444401416,2,15.6203637782904,6,1,"elevator",5,14.3383515643376
2.97888600910994,1,3.56633444401416,2,15.6203637782904,6,1,"elevator",5,12.6414777691805
3.51783381673487,1,18.8230527382094,4,45.8551029862021,9,1,"elevator",8,42.3372691694672
3.93715915820541,1,18.8230527382094,4,28.101739656479,4,1,"elevator",3,24.1645804982736
5.26960460177127,1,18.8230527382094,4,32.2042818161512,5,1,"elevator",4,26.9346772143799
6.84044546035634,1,18.8230527382094,4,51.4898535214987,10,1,"elevator",9,44.6494080611424
10.0065789980768,1,18.8230527382094,4,32.2042818161512,5,1,"elevator",4,22.1977028180744
0.630679969210178,2,1.34439057549784,1,13.8349980840884,5,1,"elevator",3,13.2043181148782
2.29093996101039,2,5.00525620683076,2,11.5063745524502,4,1,"elevator",2,9.21543459143981
2.79144610269907,2,5.00525620683076,2,20.1940013067002,8,1,"elevator",6,17.4025552040011
3.27196570663693,2,5.00525620683076,2,15.6203637782904,6,1,"elevator",4,12.3483980716535
5.47437024468041,2,19.2514612950967,4,32.2042818161512,5,1,"elevator",3,26.7299115714708
6.95855012134113,2,19.2514612950967,4,32.2042818161512,5,1,"elevator",3,25.2457316948101
7.41042649595221,2,19.2514612950967,4,42.3318745493914,7,1,"elevator",5,34.9214480534392
7.69867523795148,2,19.2514612950967,4,32.2042818161512,5,1,"elevator",3,24.5056065781997
9.19149094288372,2,19.2514612950967,4,42.3318745493914,7,1,"elevator",5,33.1403836065077
14.2500785402727,2,19.2514612950967,4,28.101739656479,4,1,"elevator",2,13.8516611162063
0.873051603282702,3,7.25558792373939,1,22.845130595635,9,1,"elevator",6,21.9720789923523
5.31517440889427,3,20.2413719788208,5,25.94487221621,1,1,"elevator",2,20.6296978073157
6.29525711167524,3,7.25558792373939,1,13.8349980840884,5,1,"elevator",2,7.53974097241316
11.2323761929407,3,29.4351714243147,5,62.6353507856907,10,1,"elevator",7,51.40297459275
11.3596283021928,3,29.4351714243147,5,42.5749028793125,6,1,"elevator",3,31.2152745771197
12.1482187508002,3,20.2413719788208,5,25.94487221621,1,1,"elevator",2,13.7966534654098
13.31486865719,3,29.4351714243147,5,42.5749028793125,6,1,"elevator",3,29.2600342221225
13.4713408498016,3,29.4351714243147,5,42.5749028793125,6,1,"elevator",3,29.1035620295109
14.6222173187384,3,29.4351714243147,5,42.5749028793125,6,1,"elevator",3,27.9526855605741
15.291570862881,3,29.4351714243147,5,61.4399612451075,9,1,"elevator",6,46.1483903822265
0.169939619178573,4,2.44183415774788,4,8.08164615744142,1,1,"elevator",3,7.91170653826285
0.734329054442545,4,28.101739656479,4,43.5503336092482,8,1,"elevator",4,42.8160045548057
3.80079180453871,4,28.101739656479,4,51.4898535214987,10,1,"elevator",6,47.68906171696
1.16316442171764,5,2,3,5.89510805195643,9,1,"elevator",4,4.73194363023879
2.86663190410815,5,13.8349980840884,1,19.3173459332115,7,1,"elevator",2,16.4507140291033
3.48485022887619,5,13.8349980840884,1,19.3173459332115,7,1,"elevator",2,15.8324957043353
2.40487941837215,6,3.43364859056639,3,5.3797739276288,8,1,"elevator",2,2.97489450925665
7.81296720065387,6,15.6203637782904,2,21.1638234945114,9,1,"elevator",3,13.3508562938575
14.1717870029759,6,15.6203637782904,2,20.1940013067002,8,1,"elevator",2,6.0222143037243
0.473566681396102,7,12.0802427795804,5,17.7038208791482,4,1,"elevator",3,17.2302541977521
4.04128770582876,7,12.0802427795804,5,22.900441616585,2,1,"elevator",5,18.8591539107562
4.31828617300934,7,12.0802427795804,5,17.7038208791482,4,1,"elevator",3,13.3855347061389
2.88313909109338,8,7.43261190586757,5,22.900441616585,2,1,"elevator",6,20.0173025254916
6.14180600946818,8,7.43261190586757,5,14.5118244399418,5,1,"elevator",3,8.37001843047362
13.2193268837955,8,18.5282795589012,3,23.9211015268053,2,1,"elevator",6,10.7017746430098
0.0244496809318662,9,4.02705061421145,5,20.2413719788208,3,1,"elevator",6,20.2169222978889
14.6914933287519,9,17.8016414481901,3,21.4801277216883,6,1,"elevator",3,6.7886343929364
16.8527062647956,9,17.8016414481901,3,22.720239840896,4,1,"elevator",5,5.8675335761004
0.828461778409991,10,1,5,22.900441616585,2,1,"elevator",8,22.071979838175
1.48101441350849,10,14.9230576639021,3,22.720239840896,4,1,"elevator",6,21.2392254273875
3.09540678690892,10,14.9230576639021,3,20.6008780882387,7,1,"elevator",3,17.5054713013298
0.466644950211048,1,1,1,14.6911668037991,7,1,"elevator",6,14.2245218535881
4.53477190227664,1,31.8145166851653,3,42.4666246214871,3,1,"elevator",2,37.9318527192105
5.81097559326269,1,31.8145166851653,3,68.7929327418764,10,1,"elevator",9,62.9819571486137
6.18009145060438,1,31.8145166851653,3,51.332091477143,7,1,"elevator",6,45.1520000265386
6.85139335706714,1,31.8145166851653,3,58.5339935907137,8,1,"elevator",7,51.6826002336466
7.12591809104846,1,31.8145166851653,3,65.4181100190171,9,1,"elevator",8,58.2921919279686
8.08501828993845,1,31.8145166851653,3,45.9934919989454,4,1,"elevator",3,37.908473709007
10.0519365385376,1,31.8145166851653,3,49.4738395040177,6,1,"elevator",5,39.4219029654801
10.4986019028552,1,31.8145166851653,3,68.7929327418764,10,1,"elevator",9,58.2943308390212
11.0380250156127,1,31.8145166851653,3,51.332091477143,7,1,"elevator",6,40.2940664615303
0.920738366390479,2,2.8863350879401,2,24.7157818178768,10,1,"elevator",8,23.7950434514863
1.7458234602646,2,2.8863350879401,2,17.1259039515395,7,1,"elevator",5,15.3800804912749
2.35395643823454,2,4.94251984495439,1,5.87935504645808,4,1,"elevator",2,3.52539860822354
2.95488124909485,2,4.94251984495439,1,14.6911668037991,7,1,"elevator",5,11.7362855547042
3.09735920429835,2,4.94251984495439,1,10.7644469501031,5,1,"elevator",3,7.66708774580475
3.67898151660944,2,4.94251984495439,1,15.0201322472034,8,1,"elevator",6,11.341150730594
4.20735609541321,2,5,4,19.7961213242316,6,1,"elevator",4,15.5887652288184
5.19837049917762,2,40.9294150724504,5,49.6655451133555,5,1,"elevator",3,44.4671746141779
5.61839094130681,2,40.9294150724504,5,47.3825190800303,4,1,"elevator",2,41.7641281387235
9.55045358185679,2,40.9294150724504,5,54.9037099880766,7,1,"elevator",5,45.3532564062198
2.34279567176912,3,4.4068611335979,2,24.7157818178768,10,1,"elevator",7,22.3729861461077
3.82314233600134,3,4.4068611335979,2,13.4350749618189,5,1,"elevator",2,9.61193262581756
4.62191836836244,3,21.1982462638996,3,24.9732299677194,1,1,"elevator",2,20.351311599357
5.83616895152208,3,45.4304228707743,5,49.6655451133555,5,1,"elevator",2,43.8293761618334
7.08649780880569,3,42.4666246214871,3,65.4181100190171,9,1,"elevator",6,58.3316122102114
7.13317884604681,3,21.1982462638996,3,24.9732299677194,1,1,"elevator",2,17.8400511216726
11.1703454806127,3,21.1982462638996,3,24.9732299677194,1,1,"elevator",2,13.8028844871067
11.9727200032299,3,21.1982462638996,3,24.9732299677194,1,1,"elevator",2,13.0005099644895
12.6658625491051,3,45.4304228707743,5,49.6655451133555,5,1,"elevator",2,36.9996825642504
12.9570739324516,3,45.4304228707743,5,49.6655451133555,5,1,"elevator",2,36.7084711809039
0.611370072389642,4,2.12004624214023,4,4.66934954895703,2,1,"elevator",2,4.05797947656739
6.37232547287452,4,7.65450344429514,4,24.2395331289728,7,1,"elevator",3,17.8672076560983
7.18005865746594,4,13.1770186697775,3,24.9732299677194,1,1,"elevator",3,17.7931713102535
2.44503577939981,5,13.3630484029805,4,44.2696244391982,9,1,"elevator",4,41.8245886597984
12.5664566490643,5,23.0920448521301,5,28.7449082514648,2,1,"elevator",3,16.1784516024005
18.977316037394,5,48.7242721542671,1,51.9989240052487,10,1,"elevator",5,33.0216079678547
1.62691656810542,6,10.165289248682,3,24.9732299677194,1,1,"elevator",5,23.346313399614
1.73600244734841,6,10.165289248682,3,13.1770186697775,4,1,"elevator",2,11.4410162224291
7.01135747448407,6,10.165289248682,3,13.1770186697775,4,1,"elevator",2,6.16566119529343
6.31081736308146,7,20.4395492790052,5,28.7449082514648,2,1,"elevator",5,22.4340908883833
8.86014183320316,7,20.4395492790052,5,23.0920448521301,5,1,"elevator",2,14.2319030189269
9.54337867866171,7,20.4395492790052,5,33.0645410928524,1,1,"elevator",6,23.5211624141907
1.11052479886123,8,17.0714998487069,5,21.9234129122607,6,1,"elevator",2,20.8128881133995
2.60584444874881,8,17.0714998487069,5,28.7449082514648,2,1,"elevator",6,26.139063802716
3.63272755077092,8,17.0714998487069,5,21.9234129122607,6,1,"elevator",2,18.2906853614898
0.823562871664762,9,9.80467356383681,5,23.0920448521301,5,1,"elevator",4,22.2684819804653
8.22040397631836,9,9.80467356383681,5,21.9234129122607,6,1,"elevator",3,13.7030089359423
13.1784848058872,9,27.521351563281,2,40.7403129754765,6,1,"elevator",3,27.5618281695893
0.0508667960090449,10,1,5,17.0714998487069,8,1,"elevator",2,17.0206330526979
0.301172761410016,10,1,5,23.0920448521301,5,1,"elevator",5,22.7908720907201
5.47279267560206,10,25,2,49.4323408150425,2,1,"elevator",8,43.9595481394404
0.391290286872362,1,1,1,6.06391687501318,4,1,"elevator",3,5.67262658814082
1.20704348878442,1,2,2,11.4735694720149,7,1,"elevator",6,10.2665259832305
1.74908044030397,1,2,2,11.4735694720149,7,1,"elevator",6,9.72448903171093
3.04252679389864,1,22.3106877924053,4,41.0488245487849,5,1,"elevator",4,38.0062977548863
3.09286375180781,1,22.3106877924053,4,41.0488245487849,5,1,"elevator",4,37.9559607969771
5.25179547549737,1,22.3106877924053,4,45.5909985452121,6,1,"elevator",5,40.3392030697147
5.83072141440229,1,22.3106877924053,4,38.6033482427837,4,1,"elevator",3,32.7726268283814
6.3417612963693,1,22.3106877924053,4,38.6033482427837,4,1,"elevator",3,32.2615869464144
11.0449001430213,1,22.3106877924053,4,45.5909985452121,6,1,"elevator",5,34.5460984021908
14.2457186219144,1,22.3106877924053,4,46.5902910334178,7,1,"elevator",6,32.3445724115034
0.615197817329317,2,4.48649603889488,2,23.4484431534737,9,1,"elevator",7,22.8332453361444
2.99355275590408,2,4.48649603889488,2,23.8124912076563,10,1,"elevator",8,20.8189384517522
4.03611749533524,2,37.3841968236863,5,43.6196713625766,7,1,"elevator",5,39.5835538672414
4.38064326235985,2,30.4620042120206,4,50.465821709727,9,1,"elevator",7,46.0851784473672
4.74055181566586,2,30.4620042120206,4,51.3318571067871,10,1,"elevator",8,46.5913052911212
6.36618576685838,2,30.4620042120206,4,38.6033482427837,4,1,"elevator",2,32.2371624759253
7.69332334509515,2,30.4620042120206,4,38.6033482427837,4,1,"elevator",2,30.9100248976886
7.95343607075908,2,30.4620042120206,4,38.6033482427837,4,1,"elevator",2,30.6499121720246
8.30197062323526,2,30.4620042120206,4,50.465821709727,9,1,"elevator",7,42.1638510864917
8.99077988349558,2,37.3841968236863,5,47.1697349635364,8,1,"elevator",6,38.1789550800408
0.427190017862712,3,4.03342469297465,1,15.4237741087881,9,1,"elevator",6,14.9965840909254
0.8463359935903,3,6.10307596700226,4,9.58685891109842,1,1,"elevator",2,8.74052291750812
2.75939183959919,3,4.03342469297465,1,9.63032451150409,6,1,"elevator",3,6.8709326719049
3.6043134042405,3,4.03342469297465,1,13.9625629392314,7,1,"elevator",4,10.3582495349909
3.97953423246447,3,4.03342469297465,1,13.9625629392314,7,1,"elevator",4,9.98302870676693
4.07291422626919,3,6.03092230307359,2,23.8124912076563,10,1,"elevator",7,19.7395769813871
5.27420064275853,3,6.03092230307359,2,23.4484431534737,9,1,"elevator",6,18.1742425107152
5.96540793897352,3,6.03092230307359,2,10.3035196812854,5,1,"elevator",2,4.33811174231188
6.35790212386987,3,38.603117129894,3,60.3230543051596,10,1,"elevator",7,53.9651521812897
9.24929434824448,3,38.603117129894,3,39.6570075814059,5,1,"elevator",2,30.4077132331614
4.25839924860402,4,38.6033482427837,4,45.5909985452121,6,1,"elevator",2,41.3325992966081
4.33769546900843,4,38.6033482427837,4,51.3318571067871,10,1,"elevator",6,46.9941616377787
7.69587297740636,4,25.50523352582,1,30.0342089954192,1,1,"elevator",3,22.3383360180128
9.72975321058051,5,21.9252024129794,1,28.5653524603376,2,1,"elevator",3,18.8355992497571
10.6079569313662,5,21.9252024129794,1,28.5653524603376,2,1,"elevator",3,17.9573955289714
12.3501484121493,5,39.6570075814059,3,51.9314074056757,7,1,"elevator",2,39.5812589935264
2.28879847098142,6,7.58428451596739,3,13.7736076300274,9,1,"elevator",3,11.484809159046
3.13025685337683,6,7.58428451596739,3,14.4765861011352,10,1,"elevator",4,11.3463292477584
3.39164600707591,6,7.58428451596739,3,14.4765861011352,10,1,"elevator",4,11.0849400940593
3.00795367904906,7,8.77082561572063,3,14.4765861011352,10,1,"elevator",3,11.4686324220861
6.92109188036927,7,19.0994713565517,1,26.0256067351215,3,1,"elevator",4,19.1045148547522
8.0822020219883,7,19.0994713565517,1,30.0342089954192,1,1,"elevator",6,21.9520069734309
0.643088817596436,8,11.1006930139071,5,29.6800692088804,2,1,"elevator",6,29.036980391284
4.66948201244974,8,11.1006930139071,5,29.0616964056516,3,1,"elevator",5,24.3922143932019
7.87843625964531,8,11.1006930139071,5,29.0616964056516,3,1,"elevator",5,21.1832601460063
2.51273965138598,9,6.11634567727275,5,30.5793508043758,1,1,"elevator",8,28.0666111529898
2.91887244195644,9,6.11634567727275,5,26.2200065875005,5,1,"elevator",4,23.3011341455441
3.54520090375994,9,6.11634567727275,5,29.6800692088804,2,1,"elevator",7,26.1348683051205
6.12660973615257,10,20.3982645413453,3,32.3344483176811,1,1,"elevator",9,26.2078385815285
6.13578691429703,10,20.3982645413453,3,27.4954291455977,3,1,"elevator",7,21.3596422313007
18.9888817186289,10,20.3982645413453,3,22.9390576301689,7,1,"elevator",3,3.95017591154
0.724805733400816,1,1,1,8.56491278668492,3,1,"elevator",2,7.8401070532841
1.06666706197658,1,2,2,21.2144331080864,10,1,"elevator",9,20.1477660461098
2.73337043694894,1,18.0448162031818,1,35.680726746144,9,1,"elevator",8,32.9473563091951
3.90624232179684,1,18.0448162031818,1,34.6213613548578,8,1,"elevator",7,30.715119033061
4.52617474747089,1,18.0448162031818,1,28.2373306497752,6,1,"elevator",5,23.7111559023043
4.76911208414671,1,18.0448162031818,1,29.3481667384721,7,1,"elevator",6,24.5790546543254
7.16773248273582,1,18.0448162031818,1,29.3481667384721,7,1,"elevator",6,22.1804342557363
7.39913558676542,1,18.0448162031818,1,34.6213613548578,8,1,"elevator",7,27.2222257680924
9.82741444820677,1,18.0448162031818,1,37.3820053739731,10,1,"elevator",9,27.5545909257663
9.90423105780174,1,18.0448162031818,1,24.3699646687628,4,1,"elevator",3,14.4657336109611
4.21692170550056,2,5.95082106381322,2,19.0011721181137,8,1,"elevator",6,14.7842504126131
4.69304200748853,2,5.95082106381322,2,14.7749760664963,5,1,"elevator",3,10.0819340590078
5.86162490353999,2,20.4631622648734,1,29.3481667384721,7,1,"elevator",5,23.4865418349321
8.07881672238743,2,20.4631622648734,1,37.3820053739731,10,1,"elevator",8,29.3031886515857
9.43477768750198,2,20.4631622648734,1,29.3481667384721,7,1,"elevator",5,19.9133890509701
11.7166371386616,2,20.4631622648734,1,24.3699646687628,4,1,"elevator",2,12.6533275301012
12.0042180827936,2,20.4631622648734,1,35.680726746144,9,1,"elevator",7,23.6765086633504
14.0685007030353,2,20.4631622648734,1,28.2373306497752,6,1,"elevator",4,14.1688299467399
14.7090459906705,2,20.4631622648734,1,35.680726746144,9,1,"elevator",7,20.9716807554735
15.4329138770137,2,20.4631622648734,1,34.6213613548578,8,1,"elevator",6,19.1884474778441
0.246018036068244,3,8.31506768133824,2,21.2144331080864,10,1,"elevator",7,20.9684150720182
1.09852735115188,3,8.31506768133824,2,14.7749760664963,5,1,"elevator",2,13.6764487153444
1.15158223188234,3,8.31506768133824,2,19.0011721181137,8,1,"elevator",5,17.8495898862314
1.40922655923976,3,8.31506768133824,2,20.6713255892053,9,1,"elevator",6,19.2620990299655
2.95593128172413,3,9,1,14.607167774821,1,1,"elevator",2,11.6512364930969
5.020146796449,3,8.31506768133824,2,17.2070722604185,6,1,"elevator",3,12.1869254639695
8.65141761278862,3,22.0432379274565,1,37.3820053739731,10,1,"elevator",7,28.7305877611845
9.85388624174173,3,22.0432379274565,1,29.3481667384721,7,1,"elevator",4,19.4942804967304
10.7061063793033,3,22.0432379274565,1,29.3481667384721,7,1,"elevator",4,18.6420603591688
11.1666690382652,3,22.0432379274565,1,29.3481667384721,7,1,"elevator",4,18.1814977002069
0.704820294243594,4,8.7920250876547,4,20.4400582874516,10,1,"elevator",6,19.735237993208
1.67044585105032,4,8.7920250876547,4,18.8442153393274,9,1,"elevator",5,17.1737694882771
7.20856346893562,4,8.7920250876547,4,10.3411387308218,6,1,"elevator",2,3.13257526188618
0.160652987348537,5,1,3,5.5634129253672,7,1,"elevator",2,5.40275993801866
1.84619682530562,5,9.82748342931468,4,12.6043567448792,8,1,"elevator",3,10.7581599195736
3.92197034011284,5,14.6278564345949,5,25.3976283788557,2,1,"elevator",3,21.4756580387429
2.44126581866456,6,8.70069356429786,5,24.2228004965807,3,1,"elevator",3,21.7815346779161
13.9668305333707,6,23.8305281092146,3,30.5001158835144,2,1,"elevator",4,16.5332853501437
14.4682757996552,6,23.8305281092146,3,32.1178632991382,1,1,"elevator",5,17.649587499483
0.103664728812873,7,7.10155004288577,5,24.2228004965807,3,1,"elevator",4,24.1191357677678
0.125027413766516,7,7.10155004288577,5,16.2159013256313,4,1,"elevator",3,16.0908739118648
5.6442343657901,7,10.8560605694028,4,18.8442153393274,9,1,"elevator",2,13.1999809735373
3.46684715696577,8,5.72455014471577,5,8.70069356429786,6,1,"elevator",2,5.23384640733209
17.2767551576388,8,35.2459702476322,4,57.5376590948057,1,1,"elevator",7,40.2609039371669
17.3767411234769,8,23.868572129868,2,35.0239827288635,2,1,"elevator",6,17.6472416053866
8.01050352295438,9,14.0366711326855,3,27.7360170247651,4,1,"elevator",5,19.7255135018107
10.1383530027812,9,14.0366711326855,3,27.7360170247651,4,1,"elevator",5,17.5976640219839
11.66151003654,9,14.0366711326855,3,26.3739498295973,5,1,"elevator",4,14.7124397930573
0.288200083499153,10,1,5,5.72455014471577,8,1,"elevator",2,5.43635006121662
0.339065040246844,10,1,5,24.2228004965807,3,1,"elevator",7,23.8837354563339
1.0107054279831,10,11.8093153490173,3,32.1178632991382,1,1,"elevator",9,31.1071578711551
2.11232387075636,1,3,2,14.7588173206214,10,1,"elevator",9,12.646493449865
2.95926728242625,1,3,2,12.776474228119,8,1,"elevator",7,9.81720694569275
3.62020630392794,1,24.5182406084434,5,39.0592185601269,6,1,"elevator",5,35.439012256199
5.65269403527088,1,24.5182406084434,5,41.3687492072056,7,1,"elevator",6,35.7160551719347
6.0438441684895,1,24.5182406084434,5,45.8063657712755,9,1,"elevator",8,39.762521602786
6.96232179775887,1,24.5182406084434,5,34.9639481634115,5,1,"elevator",4,28.0016263656526
7.1335815320728,1,24.5182406084434,5,53.895572852892,10,1,"elevator",9,46.7619913208192
7.69404678037443,1,24.5182406084434,5,41.3687492072056,7,1,"elevator",6,33.6747024268312
8.58436702085236,1,24.5182406084434,5,43.5430079457251,8,1,"elevator",7,34.9586409248727
8.73340225320451,1,24.5182406084434,5,34.9639481634115,5,1,"elevator",4,26.230545910207
0.468232573749312,2,2.81647073621613,1,16.1967132126911,7,1,"elevator",5,15.7284806389418
1.09755872636456,2,2.81647073621613,1,16.1967132126911,7,1,"elevator",5,15.0991544863265
1.25517475008853,2,2.81647073621613,1,13.8269047957836,6,1,"elevator",4,12.5717300456951
3.280559503947,2,27.5529363696526,2,50.9363508042492,10,1,"elevator",8,47.6557913003022
5.5861900781903,2,25.8783010561169,5,39.0592185601269,6,1,"elevator",4,33.4730284819366
7.02758196338689,2,27.5529363696526,2,43.5516050000695,7,1,"elevator",5,36.5240230366826
7.61708315012654,2,25.8783010561169,5,39.0592185601269,6,1,"elevator",4,31.4421354100004
7.672339858186,2,27.5529363696526,2,50.9363508042492,10,1,"elevator",8,43.2640109460632
9.1153936680279,2,27.5529363696526,2,44.9698193611051,8,1,"elevator",6,35.8544256930772
9.40804762820371,2,27.5529363696526,2,50.9363508042492,10,1,"elevator",8,41.5283031760455
0.125097025957672,3,5.42327758436254,2,14.7588173206214,10,1,"elevator",7,14.6337202946637
1.01810567433355,3,5.42327758436254,2,11.2763558543018,7,1,"elevator",4,10.2582501799683
1.1427702441669,3,5.42327758436254,2,12.776474228119,8,1,"elevator",5,11.6337039839521
2.43141597820408,3,5.42327758436254,2,13.9423841095432,9,1,"elevator",6,11.5109681313391
4.06614410902587,3,5.42327758436254,2,9.00088014251844,6,1,"elevator",3,4.93473603349257
6.61322019448222,3,33.6376234495718,2,43.5516050000695,7,1,"elevator",4,36.9383848055873
8.85031720623528,3,33.6376234495718,2,44.9698193611051,8,1,"elevator",5,36.1195021548698
8.98165358231825,3,33.6376234495718,2,41.2184518860666,6,1,"elevator",3,32.2367983037484
9.13500134275717,3,33.6376234495718,2,46.6299196968195,9,1,"elevator",6,37.4949183540623
9.40960072308269,3,33.6376234495718,2,43.5516050000695,7,1,"elevator",4,34.1420042769868
2.19456815471252,4,8.27900777773643,1,21.5502119001952,10,1,"elevator",6,19.3556437454827
4.49049396906048,4,15.9274150858407,5,20.5627006107148,1,1,"elevator",3,16.0722066416543
11.8855404866488,4,31.110938290278,5,39.0592185601269,6,1,"elevator",2,27.1736780734781
0.952421764229475,5,1,3,4.83918539138967,8,1,"elevator",3,3.88676362716019
7.6372320099799,5,14.0601936958913,4,34.5522046297474,1,1,"elevator",4,26.9149726197675
10.0940189590274,5,14.0601936958913,4,34.5522046297474,1,1,"elevator",4,24.45818567072
2.67862619197273,6,4.7568812406713,4,7.23132238345141,8,1,"elevator",2,4.55269619147868
13.320645726517,6,21.8297586674866,3,24.82732730826,4,1,"elevator",2,11.506681581743
13.992574813386,6,17.600368157134,2,23.0496447777647,2,1,"elevator",4,9.0570699643787
0.348606030884896,7,9.63981481364533,5,15.9274150858407,4,1,"elevator",3,15.5788090549558
2.86222494391357,7,9.63981481364533,5,18.6714881609525,3,1,"elevator",4,15.8092632170389
5.79786594748531,7,9.63981481364533,5,20.5627006107148,1,1,"elevator",6,14.7648346632295
3.65756078919673,8,4.44738998729918,5,10.666746356921,5,1,"elevator",3,7.00918556772427
4.76522429021407,8,16.6789301728016,2,18.7227091436098,5,1,"elevator",3,13.9574848533957
15.9979933567427,8,16.6789301728016,2,21.0326705362795,3,1,"elevator",5,5.0346771795368
1.59607481211424,9,3.00963260970058,5,18.6714881609525,3,1,"elevator",6,17.0754133488383
7.53732733400472,9,17.0290502683304,3,24.3841560021949,5,1,"elevator",4,16.8468286681902
11.0051792141816,9,17.0290502683304,3,39.495309571535,1,1,"elevator",8,28.4901303573534
1.98990350278715,10,12.2746326571654,3,24.3841560021949,5,1,"elevator",5,22.3942524994077
4.0111461483563,10,12.2746326571654,3,21.1108883034107,7,1,"elevator",3,17.0997421550544
9.97511427976746,10,12.2746326571654,3,24.82732730826,4,1,"elevator",6,14.8522130284925
0.0655843946151435,1,1,1,14.1813742210584,9,1,"elevator",8,14.1157898264433
0.939702483317715,1,1,1,5.6334142182876,3,1,"elevator",2,4.69371173496988
2.92980930801917,1,18.9957595186112,4,29.5634490011799,6,1,"elevator",5,26.6336396931607
3.38277685070846,1,18.9957595186112,4,30.8764387798313,7,1,"elevator",6,27.4936619291228
4.62534962484573,1,18.9957595186112,4,26.5795969944951,3,1,"elevator",2,21.9542473696494
5.2174767081808,1,18.9957595186112,4,38.9758856486769,9,1,"elevator",8,33.7584089404961
5.83925768203994,1,18.9957595186112,4,28.9686486244741,5,1,"elevator",4,23.1293909424342
5.96615552454029,1,18.9957595186112,4,30.8764387798313,7,1,"elevator",6,24.910283255291
6.08130116109222,1,18.9957595186112,4,28.0640387454027,4,1,"elevator",3,21.9827375843105
7.31931488212139,1,18.9957595186112,4,34.6611504485086,8,1,"elevator",7,27.3418355663872
0.409973036963493,2,1.72798286285251,1,7.21247653788897,5,1,"elevator",3,6.80250350092548
0.448180267969466,2,1.72798286285251,1,7.21247653788897,5,1,"elevator",3,6.7642962699195
1.0936401327237,2,5.43481156213169,2,20.0217817125333,8,1,"elevator",6,18.9281415798096
1.25826950595746,2,5.43481156213169,2,26.8079379181466,9,1,"elevator",7,25.5496684121891
2.12066712916385,2,5.43481156213169,2,15.4086943415934,4,1,"elevator",2,13.2880272124295
2.42039116691481,2,5.43481156213169,2,17.0678196900601,5,1,"elevator",3,14.6474285231453
2.57953486331386,2,5.43481156213169,2,17.0678196900601,5,1,"elevator",3,14.4882848267462
4.25637434899434,2,5.43481156213169,2,18.7140177268026,7,1,"elevator",5,14.4576433778083
6.09576978489888,2,23.1698918515675,4,29.5634490011799,6,1,"elevator",4,23.467679216281
6.12988267375199,2,23.1698918515675,4,40.4093443772996,10,1,"elevator",8,34.2794617035476
2.32430685485218,3,5.6334142182876,1,14.1813742210584,9,1,"elevator",6,11.8570673662062
4.3233539497242,3,5.6334142182876,1,9.93694743948346,7,1,"elevator",4,5.61359348975926
5.13154948570706,3,36.4557220302683,5,44.0534642262536,6,1,"elevator",3,38.9219147405465
9.21946804086102,3,35.6269290371119,1,56.3073997183738,10,1,"elevator",7,47.0879316775128
11.6616404767786,3,26.5795969944951,4,29.5634490011799,6,1,"elevator",3,17.9018085244013
13.7378103307246,3,26.5795969944951,4,38.9758856486769,9,1,"elevator",6,25.2380753179523
14.7600607464399,3,26.5795969944951,4,28.9686486244741,5,1,"elevator",2,14.2085878780342
15.8964288301655,3,26.5795969944951,4,29.5634490011799,6,1,"elevator",3,13.6670201710144
16.3316477869174,3,35.6269290371119,1,56.3073997183738,10,1,"elevator",7,39.9757519314564
16.8396053268494,3,20.318560854043,5,25.4128178464597,1,1,"elevator",2,8.5732125196103
1.01439194971782,4,28.0640387454027,4,40.4093443772996,10,1,"elevator",6,39.3949524275818
3.31321115978769,4,18.2740031050012,5,24.3694345359599,2,1,"elevator",2,21.0562233761722
4.39805486457509,4,28.0640387454027,4,29.5634490011799,6,1,"elevator",2,25.1653941366048
0.773718861552576,5,1,4,4.3888016024361,3,1,"elevator",2,3.61508274088352
1.43150203265326,5,16.7058501447604,5,20.318560854043,3,1,"elevator",2,18.8870588213897
2.05437305097855,5,7.21247653788897,1,9.93694743948346,7,1,"elevator",2,7.88257438850491
1.17265121390422,6,3.32742668493631,3,11.9661913759198,9,1,"elevator",3,10.7935401620156
2.23930198233575,6,13.2584482717855,5,18.2740031050012,4,1,"elevator",2,16.0347011226654
2.4892491583402,6,3.32742668493631,3,18.3389871785351,10,1,"elevator",4,15.8497380201949
0.219002321052055,7,4.46624250008649,3,18.3389871785351,10,1,"elevator",3,18.119984857483
3.96557149928961,7,12.0398890237851,5,16.7058501447604,5,1,"elevator",2,12.7402786454708
5.55144130393519,7,12.0398890237851,5,16.7058501447604,5,1,"elevator",2,11.1544088408252
5.10408457340606,8,7.20988591562207,3,18.3389871785351,10,1,"elevator",2,13.234902605129
5.53758675980626,8,10.1590090423793,5,25.4128178464597,1,1,"elevator",7,19.8752310866534
11.9044323213385,8,17.7613805728552,1,29.8933465668523,3,1,"elevator",5,17.9889142455138
1.20940175062666,9,15,1,26.8778042747049,4,1,"elevator",5,25.6684025240782
9.72297712652844,9,15,1,26.8778042747049,4,1,"elevator",5,17.1548271481765
16.6195876097756,9,25.5813494513355,3,47.2490288487314,2,1,"elevator",7,30.6294412389558
0.00253401153380378,10,1,5,12.0398890237851,7,1,"elevator",3,12.0373550122513
5.29788358807467,10,23.0818962740896,3,39.475412396968,6,1,"elevator",4,34.1775288088933
7.59688988998436,10,23.0818962740896,3,39.475412396968,6,1,"elevator",4,31.8785225069836
0.335494593251497,1,1,1,39.5882398758379,9,1,"elevator",8,39.2527452825864
0.994422734715044,1,1,1,22.3697364559873,7,1,"elevator",6,21.3753137212723
2.22285277205975,1,14.5063726160542,4,30.601151696784,6,1,"elevator",5,28.3782989247243
2.44447982307048,1,14.5063726160542,4,29.1319132174382,5,1,"elevator",4,26.6874333943677
3.9035746588646,1,14.5063726160542,4,34.8549013029514,7,1,"elevator",6,30.9513266440868
5.84078795724654,1,14.5063726160542,4,30.601151696784,6,1,"elevator",5,24.7603637395375
6.11707157810324,1,14.5063726160542,4,34.8549013029514,7,1,"elevator",6,28.7378297248482
6.76876324578137,1,14.5063726160542,4,39.9369483890267,8,1,"elevator",7,33.1681851432453
7.79325901316883,1,14.5063726160542,4,29.1319132174382,5,1,"elevator",4,21.3386542042694
8.5482939026818,1,14.5063726160542,4,26.6230205371339,3,1,"elevator",2,18.0747266344521
0.761364003285117,2,3.36219531483948,2,15.6723381194406,8,1,"elevator",6,14.9109741161555
0.874539989619798,2,3.36219531483948,2,9.96669052655642,6,1,"elevator",4,9.09215053693662
2.83867912136492,2,3.36219531483948,2,22.0045449052211,10,1,"elevator",8,19.1658657838562
4.57724442094087,2,6.00554324544906,1,20.1334614880876,5,1,"elevator",3,15.5562170671467
6.61849790564241,2,16.6398798845546,5,38.3761683521292,7,1,"elevator",5,31.7576704464868
7.29619068218829,2,16.6398798845546,5,42.3904453782934,10,1,"elevator",8,35.0942546961051
9.20387829398219,2,16.6398798845546,5,39.0837513125607,8,1,"elevator",6,29.8798730185785
11.3157302318504,2,16.6398798845546,5,26.8811809262404,4,1,"elevator",2,15.56545069439
11.9344283787881,2,16.6398798845546,5,38.3761683521292,7,1,"elevator",5,26.4417399733411
12.5505463162785,2,16.6398798845546,5,42.3904453782934,10,1,"elevator",8,29.8398990620149
0.603368536103517,3,4.15432233354988,4,7.90366097041992,1,1,"elevator",2,7.3002924343164
3.77047979861458,3,4.45839032437652,2,15.6723381194406,8,1,"elevator",5,11.901858320826
5.35809482096635,3,6.97129303210355,1,41.3239518800538,10,1,"elevator",7,35.9658570590874
5.42549986925848,3,6.97129303210355,1,22.3697364559873,7,1,"elevator",4,16.9442365867288
6.81623110846438,3,24.4119838687609,5,39.0837513125607,8,1,"elevator",5,32.2675202040963
6.87184231561142,3,24.4119838687609,5,37.3566241198375,6,1,"elevator",3,30.4847818042261
6.96540228249969,3,24.4119838687609,5,38.3761683521292,7,1,"elevator",4,31.4107660696295
8.72105314360445,3,23.1101339114372,3,26.5619366325773,1,1,"elevator",2,17.8408834889728
8.97432969759881,3,24.4119838687609,5,38.3761683521292,7,1,"elevator",4,29.4018386545304
9.43929298412853,3,24.4119838687609,5,30.9647911220139,5,1,"elevator",2,21.5254981378854
1.07175515654186,4,6.25216451880375,2,9.96669052655642,6,1,"elevator",2,8.89493537001456
3.64131860528642,4,10.5916727656273,5,12.8945103749692,2,1,"elevator",2,9.25319176968278
6.76376927413203,4,26.8811809262404,5,41.4167971953663,9,1,"elevator",5,34.6530279212343
2.26642248841623,5,31.6953458429657,3,32.9554025387097,8,1,"elevator",3,30.6889800502935
3.89097901216398,5,29.1319132174382,4,34.8549013029514,7,1,"elevator",2,30.9639222907874
5.50062370641778,5,10.0516099497967,5,14.4496768571243,1,1,"elevator",4,8.94905315070652
0.617362310489019,6,1.9571612495929,3,9.47402331840278,10,1,"elevator",4,8.85666100791376
2.81088508820782,6,9.96669052655642,2,22.0045449052211,10,1,"elevator",4,19.1936598170133
4.59934432680408,6,8.94986057219438,5,10.5916727656273,4,1,"elevator",2,5.99232843882322
3.67918221576417,7,7.57839500567269,5,14.4496768571243,1,1,"elevator",6,10.7704946413601
7.06814832026073,7,18.3039144499187,3,23.1101339114372,3,1,"elevator",4,16.0419855911765
8.35896023210693,7,11.4021020587208,2,22.0045449052211,10,1,"elevator",3,13.6455846731142
13.4910224228697,8,15.6723381194406,2,22.0045449052211,10,1,"elevator",2,8.5135224823514
15.1439441699755,8,30,2,36.2321883661015,10,1,"elevator",2,21.088244196126
16.1407174967449,8,30,2,36.2321883661015,10,1,"elevator",2,20.0914708693566
0.0107111964483092,9,2.02860523480922,5,14.4496768571243,1,1,"elevator",8,14.438965660676
6.29599666779636,9,17.7196984918785,3,19.3679391579614,6,1,"elevator",3,13.071942490165
14.0545255369754,9,17.7196984918785,3,23.1101339114372,3,1,"elevator",6,9.0556083744618
0.247813854489474,10,1,5,12.8945103749692,2,1,"elevator",8,12.6466965204797
1.43323215564185,10,14.6531468530557,3,19.3679391579614,6,1,"elevator",4,17.9347070023195
7.78696219937903,10,14.6531468530557,3,18.3039144499187,7,1,"elevator",3,10.5169522505397
1.61438449461997,1,2,2,16.0728905857708,5,1,"elevator",4,14.4585060911508
2.28143845022708,1,10.7633201880543,3,23.0367881036636,4,1,"elevator",3,20.7553496534365
2.4459026371041,1,10.7633201880543,3,27.3059516260689,5,1,"elevator",4,24.8600489889648
2.75122797339276,1,10.7633201880543,3,20.2063058693647,3,1,"elevator",2,17.4550778959719
2.88330226614192,1,10.7633201880543,3,27.3059516260689,5,1,"elevator",4,24.422649359927
3.71840677070008,1,10.7633201880543,3,20.2063058693647,3,1,"elevator",2,16.4878990986646
4.67650171583551,1,10.7633201880543,3,43.7414270071373,10,1,"elevator",9,39.0649252913018
4.72251354124867,1,10.7633201880543,3,41.7682075607476,9,1,"elevator",8,37.0456940194989
5.90809243507678,1,10.7633201880543,3,28.097639382328,6,1,"elevator",5,22.1895469472512
7.00797996442284,1,10.7633201880543,3,29.8670387600109,7,1,"elevator",6,22.8590587955881
2.3064425285144,2,8.61061411182413,2,16.4264943008246,6,1,"elevator",4,14.1200517723102
2.34863535016784,2,8.61061411182413,2,20.911857931966,10,1,"elevator",8,18.5632225817982
5.56036244017972,2,8.61061411182413,2,14.3618826169252,4,1,"elevator",2,8.80152017674548
5.96075324119969,2,8.61061411182413,2,16.0728905857708,5,1,"elevator",3,10.1121373445711
6.11448052024437,2,8.61061411182413,2,20.911857931966,10,1,"elevator",8,14.7973774117216
8.93610345799405,2,18.1803292963935,3,29.8670387600109,7,1,"elevator",5,20.9309353020168
9.02768989762177,2,38.8073115082737,5,56.8661927309035,5,1,"elevator",3,47.8385028332817
9.09932190382738,2,37,4,54.8709321017052,8,1,"elevator",6,45.7716101978778
10.0341778923257,2,18.1803292963935,3,27.3059516260689,5,1,"elevator",3,17.2717737337432
10.1840506577364,2,18.1803292963935,3,41.7682075607476,9,1,"elevator",7,31.5841569030112
3.72714271189129,3,9.54347011557948,2,20.7316417690508,9,1,"elevator",6,17.0044990571595
3.75931019361547,3,9.54347011557948,2,16.0728905857708,5,1,"elevator",2,12.3135803921553
5.74933490360552,3,9.54347011557948,2,19.9762932916081,8,1,"elevator",5,14.2269583880026
6.66919885783464,3,9.54347011557948,2,16.4264943008246,6,1,"elevator",3,9.75729544298996
6.84909030429011,3,9.54347011557948,2,20.911857931966,10,1,"elevator",7,14.0627676276759
7.20136906832673,3,22.4586587416217,5,24.8492735477307,1,1,"elevator",2,17.647904479404
10.1531689451466,3,39.8318488679917,4,54.8709321017052,8,1,"elevator",5,44.7177631565586
10.7486462896149,3,39.8318488679917,4,51.2877163439498,6,1,"elevator",3,40.5390700543349
12.9106315612998,3,39.8318488679917,4,54.8709321017052,8,1,"elevator",5,41.9603005404054
13.3778132834676,3,22.4586587416217,5,24.8492735477307,1,1,"elevator",2,11.4714602642631
0.309971350555619,4,3.84568824144992,1,19.1781391065916,9,1,"elevator",5,18.868167756036
3.61189182523294,4,21.2330764376301,5,24.8492735477307,1,1,"elevator",3,21.2373817224978
10.1794658814392,4,14.3618826169252,2,17.5672670901393,7,1,"elevator",3,7.3878012087001
4.04963835438991,5,6.82297252776993,1,21.4453526082332,10,1,"elevator",5,17.3957142538433
11.148472223489,5,27.3059516260689,3,40.9880862188179,8,1,"elevator",3,29.8396139953289
21.9460639290458,5,27.3059516260689,3,40.9880862188179,8,1,"elevator",3,19.0420222897721
6.8315435198129,6,9.8503155635822,1,15.0423766757082,8,1,"elevator",2,8.2108331558953
11.5930686699213,6,26.8238815282372,2,39.6840573075681,3,1,"elevator",3,28.0909886376468
13.3685685595484,6,16.4264943008246,2,20.911857931966,10,1,"elevator",4,7.5432893724176
0.858723241835833,7,5.36085298992157,5,21.2330764376301,4,1,"elevator",3,20.3743531957943
1.98864156535516,7,4.5695436417803,4,7.08931982875801,10,1,"elevator",3,5.10067826340285
8.06611135729212,7,26.4057626955393,2,30.2883182897653,5,1,"elevator",2,22.2222069324732
12.0394551933261,8,21.6226547631077,4,27.3583109617389,6,1,"elevator",2,15.3188557684128
14.5794785172128,8,21.6226547631077,4,36.2517015585232,2,1,"elevator",6,21.6722230413104
16.4922663862314,8,21.6226547631077,4,36.6306094602005,1,1,"elevator",7,20.1383430739691
0.958436242463586,9,1.84101982976725,5,11.6509220412863,5,1,"elevator",4,10.6924857988227
3.9274282589122,9,16.2554234883781,4,29.739434523203,4,1,"elevator",5,25.8120062642908
5.77670998706621,9,16.2554234883781,4,27.8284639188208,5,1,"elevator",4,22.0517539317546
0.670102657750249,10,1,5,23.1617297887707,2,1,"elevator",8,22.4916271310205
3.0304442992002,10,26.9750126922879,1,29.848128354749,8,1,"elevator",2,26.8176840555488
4.42218575100752,10,26.9750126922879,1,48.5205315448599,1,1,"elevator",9,44.0983457938524
0.638481938280165,1,1,1,16.5924067747214,5,1,"elevator",4,15.9539248364412
3.75118461811439,1,17.8431004433397,3,44.8149934034874,10,1,"elevator",9,41.063808785373
4.74411863644587,1,17.8431004433397,3,25.1943978601393,3,1,"elevator",2,20.4502792236934
5.4421575612628,1,17.8431004433397,3,30.4779021320741,7,1,"elevator",6,25.0357445708113
5.87434975104191,1,17.8431004433397,3,44.8149934034874,10,1,"elevator",9,38.9406436524455
6.3028099117779,1,17.8431004433397,3,30.4779021320741,7,1,"elevator",6,24.1750922202962
6.58967603888254,1,17.8431004433397,3,29.4561425034147,5,1,"elevator",4,22.8664664645322
7.74337531745581,1,17.8431004433397,3,38.9970982361623,8,1,"elevator",7,31.2537229187065
9.38311856979895,1,17.8431004433397,3,41.0811000622706,9,1,"elevator",8,31.6979814924716
12.0593342201867,1,17.8431004433397,3,41.0811000622706,9,1,"elevator",8,29.0217658420839
1.65763987033608,2,2.89702034120672,1,16.5924067747214,5,1,"elevator",3,14.9347669043853
4.19758088493204,2,24.4552582379979,3,27.1832708043861,4,1,"elevator",2,22.9856899194541
5.16658679650105,2,24.4552582379979,3,30.4779021320741,7,1,"elevator",5,25.311315335573
6.21500509296008,2,24.4552582379979,3,44.8149934034874,10,1,"elevator",8,38.5999883105273
6.31202553235319,2,24.4552582379979,3,30.4779021320741,7,1,"elevator",5,24.1658765997209
6.48747013951045,2,32.3257205613616,5,49.9147980802945,10,1,"elevator",8,43.4273279407841
10.1516411145474,2,32.3398490967229,4,34.984809261055,4,1,"elevator",2,24.8331681465076
10.5068901656547,2,32.3257205613616,5,49.9147980802945,10,1,"elevator",8,39.4079079146398
11.687663163983,2,24.4552582379979,3,29.4561425034147,5,1,"elevator",3,17.7684793394317
13.2484892661706,2,24.4552582379979,3,29.4561425034147,5,1,"elevator",3,16.2076532372441
0.85513713858546,3,3.50317403887312,2,13.7755928917873,6,1,"elevator",3,12.9204557532018
3.00349305646454,3,8.56929837216641,1,17.3147359708023,6,1,"elevator",3,14.3112429143378
3.24506432681658,3,8.56929837216641,1,17.3147359708023,6,1,"elevator",3,14.0696716439857
3.40326023543192,3,8.56929837216641,1,30.0498415384704,10,1,"elevator",7,26.6465813030385
4.65064394538685,3,8.56929837216641,1,30.0498415384704,10,1,"elevator",7,25.3991975930835
5.4324608618851,3,8.56929837216641,1,17.3147359708023,6,1,"elevator",3,11.8822751089172
6.95304374735138,3,8.56929837216641,1,22.4815759485424,8,1,"elevator",5,15.528532201191
7.10202103538572,3,8.56929837216641,1,17.3147359708023,6,1,"elevator",3,10.2127149354166
10.0411898386115,3,25.1943978601393,3,44.8149934034874,10,1,"elevator",7,34.7738035648759
10.6541268121833,3,25.1943978601393,3,41.0811000622706,9,1,"elevator",6,30.4269732500873
2.97165847058996,4,6.45704253373628,3,17.0237361692996,1,1,"elevator",3,14.0520776987096
3.87448700706611,4,6.95822437341371,2,15.6437222946986,8,1,"elevator",4,11.7692352876325
4.22154640689719,4,6.95822437341371,2,13.7755928917873,6,1,"elevator",2,9.55404648489011
1.51120000561264,5,2,4,4.66357417453402,8,1,"elevator",3,3.15237416892138
6.27504465184604,5,13.5585741044568,2,14.5403057937595,7,1,"elevator",2,8.26526114191346
6.78410021192465,5,14.8686095992911,4,25.3906337071168,2,1,"elevator",3,18.6065334951921
3.95371050249442,6,13.7755928917873,2,16.0826067552541,9,1,"elevator",3,12.1288962527597
8.13909284432042,6,13.7755928917873,2,15.6437222946986,8,1,"elevator",2,7.50462945037818
8.44593595064489,6,13.7755928917873,2,15.6437222946986,8,1,"elevator",2,7.19778634405371
9.56772210641321,7,14.5403057937595,2,16.0826067552541,9,1,"elevator",2,6.51488464884089
12.0950056324021,7,27.9857455955982,2,32.6093568845596,4,1,"elevator",3,20.5143512521575
16.9644060426958,7,21.6535130784218,1,30.0498415384704,10,1,"elevator",3,13.0854354957746
3.06279408858484,8,10.6609038106713,5,21.6412424203171,3,1,"elevator",5,18.5784483317323
16.6742060058394,8,24.0626030824892,2,36.3336359752106,1,1,"elevator",7,19.6594299693712
21.8396552138174,8,24.0626030824892,2,35.4566311893749,2,1,"elevator",6,13.6169759755575
2.9976185937564,9,8.66933775984038,4,25.3906337071168,2,1,"elevator",7,22.3930151133604
3.96222632829998,9,8.66933775984038,4,11.6536321055975,6,1,"elevator",3,7.69140577729752
7.08194294297895,9,8.66933775984038,4,31.7571268550443,1,1,"elevator",8,24.6751839120654
1.87354877746354,10,2,5,26.6973425064712,1,1,"elevator",9,24.8237937290077
5.22258179518648,10,17.9833135136244,2,35.4566311893749,2,1,"elevator",8,30.2340493941884
8.46055609726878,10,17.9833135136244,2,30.192304941992,6,1,"elevator",4,21.7317488447232
0.791030982574246,1,1,1,25.9078907976162,7,1,"elevator",6,25.116859815042
0.803282257324495,1,1,1,23.374305948484,4,1,"elevator",3,22.5710236911595
1.50593326810872,1,2,2,6.50074224374251,4,1,"elevator",3,4.99480897563379
3.40240634885896,1,17.222255789802,5,22.0275173138845,3,1,"elevator",2,18.6251109650255
4.08462214936782,1,17.222255789802,5,22.0275173138845,3,1,"elevator",2,17.9428951645167
4.26906885859836,1,17.222255789802,5,30.6070993095495,8,1,"elevator",7,26.3380304509511
7.2063983369922,1,17.222255789802,5,27.282780802722,5,1,"elevator",4,20.0763824657298
7.22959123197224,1,17.222255789802,5,29.5548578722092,6,1,"elevator",5,22.325266640237
7.84090979275506,1,17.222255789802,5,27.282780802722,5,1,"elevator",4,19.4418710099669
9.3275152673964,1,17.222255789802,5,30.6070993095495,8,1,"elevator",7,21.2795840421531
1.21193384654344,2,5.19234423288138,2,21.989124701305,9,1,"elevator",7,20.7771908547616
2.74024267761473,2,5.19234423288138,2,14.9953160657987,7,1,"elevator",5,12.255073388184
2.9216130822487,2,5.19234423288138,2,17.316822762762,8,1,"elevator",6,14.3952096805133
3.60282163690402,2,5.19234423288138,2,9.30260761098518,5,1,"elevator",3,5.69978597408116
3.62657608041166,2,5.19234423288138,2,9.30260761098518,5,1,"elevator",3,5.67603153057352
6.04811973524561,2,11.5939018914949,1,35.0169550527258,10,1,"elevator",8,28.9688353174802
6.37912453691756,2,11.5939018914949,1,33.4579517575539,9,1,"elevator",7,27.0788272206363
9.89339319187171,2,11.5939018914949,1,25.9078907976162,7,1,"elevator",5,16.0144976057445
10.0958721231572,2,11.5939018914949,1,25.9078907976162,7,1,"elevator",5,15.812018674459
12.4259609824551,2,20.2536742742265,4,37.1038096755546,7,1,"elevator",5,24.6778486930995
1.26099484130265,3,5.97161919316271,2,21.989124701305,9,1,"elevator",6,20.7281298600023
3.83467681596016,3,5.97161919316271,2,21.989124701305,9,1,"elevator",6,18.1544478853448
5.6789152275113,3,18.0549661182148,1,31.1891638701317,8,1,"elevator",5,25.5102486426204
6.45271480582847,3,24.161399153498,4,44.6976104128737,9,1,"elevator",6,38.2448956070452
8.12325706451372,3,22.0275173138845,5,27.282780802722,5,1,"elevator",2,19.1595237382083
10.5424884824944,3,22.0275173138845,5,33.4576452790784,10,1,"elevator",7,22.915156796584
12.5238746484763,3,18.0549661182148,1,35.0169550527258,10,1,"elevator",7,22.4930804042495
14.4101190460027,3,34.7579062862788,3,36.6645584732021,1,1,"elevator",2,22.2544394271994
15.7243826328469,3,24.161399153498,4,38.6347064580268,8,1,"elevator",5,22.9103238251799
17.9713709795211,3,18.0549661182148,1,25.9078907976162,7,1,"elevator",4,7.9365198180951
2.81250933198145,4,7.48684730180843,4,16.0158348316729,2,1,"elevator",2,13.2033254996915
3.16757911740167,4,23.374305948484,1,35.0169550527258,10,1,"elevator",6,31.8493759353241
7.00359502096302,4,25.737712032986,4,35.2821319035823,6,1,"elevator",2,28.2785368826193
2.72098895769223,5,27.282780802722,5,33.4576452790784,10,1,"elevator",5,30.7366563213862
6.58501237913279,5,27.282780802722,5,30.6070993095495,8,1,"elevator",3,24.0220869304167
8.61404262455114,5,29.9621662144855,3,34.7579062862788,3,1,"elevator",2,26.1438636617277
0.665127624653799,6,4.70993941022229,4,7.48684730180843,4,1,"elevator",2,6.82171967715463
1.91221619076582,6,2.33045211713761,3,15.8421341570791,10,1,"elevator",4,13.9299179663133
2.5316831567839,6,4.70993941022229,4,17.0958665220276,1,1,"elevator",5,14.5641833652437
0.316811569809752,7,5.51351620664653,3,12.9421998789601,9,1,"elevator",2,12.6253883091503
2.66585368912804,7,5.51351620664653,3,12.9421998789601,9,1,"elevator",2,10.2763461898321
4.05158006891188,7,6.71497315549477,5,11.7927250504022,2,1,"elevator",5,7.74114498149032
4.7186806919357,8,5.2006788826473,5,7.97616951087009,5,1,"elevator",3,3.25748881893439
7.03343125328632,8,10.3985891300696,3,15.8421341570791,10,1,"elevator",2,8.80870290379278
13.8848900011879,8,22.7716112736921,3,33.4690694797341,4,1,"elevator",4,19.5841794785462
0.244842185901609,9,4.17795081587048,5,13.6860205243267,1,1,"elevator",8,13.4411783384251
0.638335428152986,9,4.17795081587048,5,10.1524372104315,3,1,"elevator",6,9.51410178227851
3.98319924976678,9,4.17795081587048,5,13.6860205243267,1,1,"elevator",8,9.70282127455992
0.31137562977771,10,1,5,5.2006788826473,8,1,"elevator",2,4.88930325286959
4.14938725517098,10,17.0239629480248,3,33.4690694797341,4,1,"elevator",6,29.3196822245631
9.18419347143612,10,17.0239629480248,3,33.4690694797341,4,1,"elevator",6,24.284876008298
2.14749728997561,1,13.7808177220317,4,28.9253077873636,9,1,"rope",8,26.777810497388
2.87403698371027,1,13.7808177220317,4,18.9447222168488,4,1,"rope",3,16.0706852331385
3.47533178295244,1,13.7808177220317,4,31.6442590010035,10,1,"rope",9,28.1689272180511
4.65072648316799,1,13.7808177220317,4,17.7422430978707,3,1,"rope",2,13.0915166147027
4.68152030041619,1,13.7808177220317,4,21.430002197776,5,1,"rope",4,16.7484818973598
6.31674034741865,1,13.7808177220317,4,17.7422430978707,3,1,"rope",2,11.425502750452
6.39328113232897,1,13.7808177220317,4,22.366093010585,6,1,"rope",5,15.972811878256
7.27951603599506,1,13.7808177220317,4,18.9447222168488,4,1,"rope",3,11.6652061808537
7.50063734911159,1,13.7808177220317,4,28.5578581864478,8,1,"rope",7,21.0572208373362
9.04713106929082,1,13.7808177220317,4,18.9447222168488,4,1,"rope",3,9.89759114755798
1.636411935007,2,4.33841693012004,1,17.3591693393853,6,1,"rope",4,15.7227574043783
1.83941006558927,2,4.33841693012004,1,22.8523043358881,10,1,"rope",8,21.0128942702988
1.96955711665543,2,4.33841693012004,1,22.2352728667386,9,1,"rope",7,20.2657157500832
2.77087899005476,2,4.33841693012004,1,17.3591693393853,6,1,"rope",4,14.5882903493305
3.49106151314412,2,4.33841693012004,1,21.1285569852913,8,1,"rope",6,17.6374954721472
4.33332820774667,2,9.59545504108771,2,21.6008774634832,5,1,"rope",3,17.2675492557365
4.47075368303485,2,9.59545504108771,2,36.7340667022291,8,1,"rope",6,32.2633130191942
5.29817586041191,2,9.59545504108771,2,18.7661642341668,4,1,"rope",2,13.4679883737549
5.31388670087927,2,9.59545504108771,2,33.5852914002347,7,1,"rope",5,28.2714046993554
7.09242455348488,2,9.59545504108771,2,21.6008774634832,5,1,"rope",3,14.5084529099983
1.44788782112507,3,33.0442183316705,5,41.2223582884975,6,1,"rope",3,39.7744704673724
2.07857733359767,3,33.0442183316705,5,39.298708917505,5,1,"rope",2,37.2201315839073
3.05625198544666,3,33.0442183316705,5,39.298708917505,5,1,"rope",2,36.2424569320583
3.81496168299613,3,33.0442183316705,5,52.5413696762704,9,1,"rope",6,48.7264079932743
3.82441120742788,3,33.0442183316705,5,54.8489577292626,10,1,"rope",7,51.0245465218347
4.04600457250108,3,20.0661352736693,5,26.9002404596585,1,1,"rope",2,22.8542358871574
4.65022809951534,3,33.0442183316705,5,54.8489577292626,10,1,"rope",7,50.1987296297473
4.69013947210242,3,20.0661352736693,5,26.9002404596585,1,1,"rope",2,22.2101009875561
4.72508413599786,3,33.0442183316705,5,46.5262511099467,7,1,"rope",4,41.8011669739488
6.44374508657454,3,33.0442183316705,5,52.5413696762704,9,1,"rope",6,46.0976245896959
0.351469358429313,4,55.5136948882489,1,65.4967747980717,9,1,"rope",5,65.1453054396424
1.07151046705743,4,55.5136948882489,1,57.4133302409043,6,1,"rope",2,56.3418197738469
14.8056411456766,4,55.5136948882489,1,65.4967747980717,9,1,"rope",5,50.6911336523951
2.96971453379192,5,21.6008774634832,2,33.5852914002347,7,1,"rope",2,30.6155768664428
11.7858105275364,5,21.6008774634832,2,42.1503828052905,10,1,"rope",5,30.3645722777541
13.1839904979076,5,21.6008774634832,2,36.7340667022291,8,1,"rope",3,23.5500762043215
0.650893258862197,6,13.217949691999,5,22.5526356349273,2,1,"rope",4,21.9017423760651
3.37598182244175,6,13.217949691999,5,22.5526356349273,2,1,"rope",4,19.1766538124855
4.21036088356697,6,17.3591693393853,1,21.1285569852913,8,1,"rope",2,16.9181961017243
3.29561423555604,7,9.71896779538203,5,22.5526356349273,2,1,"rope",5,19.2570213993713
9.39276805785695,7,33.2835345417806,3,37.030331221263,5,1,"rope",2,27.637563163406
11.541611656409,7,33.2835345417806,3,39.2405673409521,4,1,"rope",3,27.6989556845431
1.9632137613371,8,4.40954925986472,3,9.72126597322183,10,1,"rope",2,7.75805221188473
13.8118846195268,8,32.1082812624044,3,50.7737686554735,2,1,"rope",6,36.9618840359467
17.922161129084,8,32.1082812624044,3,50.7737686554735,2,1,"rope",6,32.8516075263895
1.62475671552335,9,3.42845627098324,5,13.217949691999,6,1,"rope",3,11.5931929764756
2.09343120863605,9,3.42845627098324,5,22.5526356349273,2,1,"rope",7,20.4592044262912
5.89509822511646,9,21.2083782809183,3,35.4174722400661,6,1,"rope",3,29.5223740149496
4.55865971419617,10,18.0587928814412,3,50.7737686554735,2,1,"rope",8,46.2151089412773
16.7965450441711,10,18.0587928814412,3,32.1082812624044,8,1,"rope",2,15.3117362182333
21.277440661387,10,30.3448926712002,1,45.9247491966851,1,1,"rope",9,24.6473085352981
1.83584305821898,1,4.22790452717114,2,13.548022317831,5,1,"rope",4,11.712179259612
2.23668390371594,1,4.22790452717114,2,11.0103422265683,4,1,"rope",3,8.77365832285236
2.50628818710092,1,4.22790452717114,2,11.0103422265683,4,1,"rope",3,8.50405403946738
5.42518728348144,1,6.6030549207934,4,10.1328380397397,3,1,"rope",2,4.70765075625826
7.07062484251032,1,23.6945676388611,5,31.1709602659498,4,1,"rope",3,24.1003354234395
7.77921057259686,1,23.6945676388611,5,31.1709602659498,4,1,"rope",3,23.3917496933529
8.255693593994,1,23.6945676388611,5,30.4074977367673,3,1,"rope",2,22.1518041427733
8.26057435803823,1,23.6945676388611,5,44.55823269951,10,1,"rope",9,36.2976583414718
10.6050061922076,1,23.6945676388611,5,31.1709602659498,4,1,"rope",3,20.5659540737422
12.3843671793696,1,23.6945676388611,5,42.0885497274395,8,1,"rope",7,29.7041825480699
2.99709462357645,2,9.06033508998467,4,14.2961240325344,8,1,"rope",6,11.299029408958
3.07521490683738,2,9.06033508998467,4,14.0651805414092,7,1,"rope",5,10.9899656345718
5.19587766483821,2,9.06033508998467,4,10.979843902546,4,1,"rope",2,5.78396623770779
5.21403265464187,2,9.06033508998467,4,16.4608516307399,10,1,"rope",8,11.246818976098
5.85598322887972,2,9.06033508998467,4,13.13372931525,5,1,"rope",3,7.27774608637028
5.9896662546165,2,9.06033508998467,4,14.2961240325344,8,1,"rope",6,8.3064577779179
6.37501845404801,2,9.06033508998467,4,14.0651805414092,7,1,"rope",5,7.69016208736119
9.84232273386571,2,12.6093116785747,1,28.8686979255814,10,1,"rope",8,19.0263751917157
11.3351164026411,2,12.6093116785747,1,26.5792121098917,9,1,"rope",7,15.2440957072506
12.04360525811,2,33.8639620809189,4,45.7469917891717,6,1,"rope",4,33.7033865310617
0.45826866918947,3,2.29778223950416,4,5.2172766725685,1,1,"rope",2,4.75900800337903
1.3521897259098,3,13.6850710271274,1,28.8686979255814,10,1,"rope",7,27.5165081996716
1.76501678507072,3,13.6850710271274,1,26.06826196409,8,1,"rope",5,24.3032451790193
2.35262277926546,3,13.6850710271274,1,26.5792121098917,9,1,"rope",6,24.2265893306262
3.27469560797079,3,13.6850710271274,1,26.5792121098917,9,1,"rope",6,23.3045165019209
3.98921188069715,3,13.6850710271274,1,26.06826196409,8,1,"rope",5,22.0790500833929
4.70974147045717,3,13.6850710271274,1,22.3070461723136,6,1,"rope",3,17.5973047018564
4.74558691546053,3,7.91399010502672,5,13.5413783690326,1,1,"rope",2,8.79579145357207
7.00445362592284,3,31.4129063541128,3,33.6991555472306,1,1,"rope",2,26.6947019213078
8.41024262488968,3,13.6850710271274,1,26.5792121098917,9,1,"rope",6,18.168969485002
0.718671965054169,4,11.0103422265683,2,22.294875933916,8,1,"rope",4,21.5762039688618
3.75935909009033,4,11.0103422265683,2,19.1556244602237,6,1,"rope",2,15.3962653701334
6.24309133175117,4,11.0103422265683,2,20.5772385382369,7,1,"rope",3,14.3341472064857
5.65908128395801,5,13.548022317831,2,20.5772385382369,7,1,"rope",2,14.9181572542789
10.4489763815603,5,26.8379970456796,3,31.4129063541128,3,1,"rope",2,20.9639299725525
13.7990753117581,5,31.7916413392569,5,44.55823269951,10,1,"rope",5,30.7591573877519
4.74331281761407,6,25.9668151506182,3,31.4129063541128,3,1,"rope",3,26.6695935364987
4.75194986436595,6,19.1556244602237,2,26.2131532518423,9,1,"rope",3,21.4612033874763
6.62732347621488,6,25.9668151506182,3,30.1985691329289,4,1,"rope",2,23.571245656714
0.00949687134416117,7,3.03482920457046,5,13.5413783690326,1,1,"rope",6,13.5318814976884
11.3688572875143,7,25.1258348263759,3,33.6991555472306,1,1,"rope",6,22.3302982597163
18.1565228977463,7,20.5772385382369,2,26.2131532518423,9,1,"rope",2,8.056630354096
13.0338600457164,8,14.2961240325344,4,16.4608516307399,10,1,"rope",2,3.4269915850235
14.1319944810535,8,22.294875933916,2,28.0301082752623,10,1,"rope",2,13.8981137942088
14.6984951081788,8,24.6653315096121,3,25.9668151506182,6,1,"rope",2,11.2683200424394
0.238660086567203,9,1.19254660088937,5,7.91399010502672,3,1,"rope",6,7.67533001845952
1.97676601974914,9,25.2082038271366,4,28.365911407904,6,1,"rope",3,26.3891453881549
10.204662118747,9,25.2082038271366,4,27.9858595612881,7,1,"rope",2,17.7811974425411
3.86708438410784,10,20.4521263823787,4,30.0609517172492,5,1,"rope",5,26.1938673331414
9.9302240646008,10,20.4521263823787,4,28.365911407904,6,1,"rope",4,18.4356873433032
10.1300622304155,10,20.4521263823787,4,27.9858595612881,7,1,"rope",3,17.8557973308726
0.171612387980027,1,1,1,27.2139315733129,7,1,"rope",6,27.0423191853329
0.755443096617861,1,1,1,42.0292012401068,10,1,"rope",9,41.2737581434889
1.88134161145013,1,4.41564646343869,2,27.0049432163761,10,1,"rope",9,25.123601604926
2.07284666453075,1,4.41564646343869,2,27.0049432163761,10,1,"rope",9,24.9320965518453
2.31211108622068,1,4.41564646343869,2,20.6887415280981,9,1,"rope",8,18.3766304418774
3.21605141643817,1,4.41564646343869,2,13.347441516875,3,1,"rope",2,10.1313901004368
4.01562124296929,1,20.4561626241714,5,26.1410246097392,5,1,"rope",4,22.1254033667699
4.57567267531435,1,20.4561626241714,5,31.3432918186961,7,1,"rope",6,26.7676191433817
5.46071164201085,1,20.4561626241714,5,37.1966864523659,10,1,"rope",9,31.7359748103551
5.48821430311609,1,20.4561626241714,5,24.8540101920494,4,1,"rope",3,19.3657958889333
3.328243329953,2,4.23895634285883,1,11.0281642427753,5,1,"rope",3,7.6999209128223
3.54380452988629,2,4.23895634285883,1,39.1234174038203,9,1,"rope",7,35.579612873934
3.61947035803219,2,4.23895634285883,1,39.1234174038203,9,1,"rope",7,35.5039470457881
4.72021709392062,2,11.9282735460649,2,16.9963571778103,4,1,"rope",2,12.2761400838897
6.35176711903148,2,11.9282735460649,2,18.9644974885177,7,1,"rope",5,12.6127303694862
9.49091028386021,2,11.9282735460649,2,16.9963571778103,4,1,"rope",2,7.50544689395009
9.89220070383737,2,11.9282735460649,2,27.0049432163761,10,1,"rope",8,17.1127425125387
11.616018050132,2,20.7653212409219,5,37.1966864523659,10,1,"rope",8,25.5806684022339
12.903644419015,2,20.7653212409219,5,36.4905204476603,9,1,"rope",7,23.5868760286453
14.147691321257,2,20.7653212409219,5,33.3898467012311,8,1,"rope",6,19.2421553799741
0.195436133519971,3,2.24615620356053,4,9.39550656707827,1,1,"rope",2,9.2000704335583
0.317873865814173,3,30.5115136057079,4,42.7372150443051,7,1,"rope",4,42.4193411784909
2.40666633690327,3,30.5115136057079,4,41.7163620968603,6,1,"rope",3,39.309695759957
2.62349325404123,3,30.5115136057079,4,43.4440168109851,8,1,"rope",5,40.8205235569439
2.68581360519652,3,30.5115136057079,4,39.5105092174879,5,1,"rope",2,36.8246956122914
3.60256056424475,3,30.5115136057079,4,44.4270784388333,9,1,"rope",6,40.8245178745886
4.19488554571068,3,30.5115136057079,4,42.7372150443051,7,1,"rope",4,38.5423294985944
5.23207696691761,3,30.5115136057079,4,39.5105092174879,5,1,"rope",2,34.2784322505703
7.26005513935936,3,30.5115136057079,4,45.6660243812934,10,1,"rope",7,38.405969241934
8.12546186957119,3,30.5115136057079,4,44.4270784388333,9,1,"rope",6,36.3016165692621
1.05470105074346,4,48.5173456199846,3,60.8248476398626,9,1,"rope",5,59.7701465891191
2.58130310517895,4,48.5173456199846,3,59.4407876066381,8,1,"rope",4,56.8594845014591
3.75309606031674,4,9.75352066907052,5,17.2550400157016,1,1,"rope",3,13.5019439553849
0.517372296502193,5,1,3,6.39653434528363,8,1,"rope",3,5.87916204878144
2.85548655754492,5,49.2390093442788,3,59.4407876066381,8,1,"rope",3,56.5853010490932
8.1725342085302,5,20.0119760001825,3,28.8361340131861,3,1,"rope",2,20.6635998046559
0.349919406049791,6,5.07350421844736,5,12.3244100497176,3,1,"rope",3,11.9744906436678
6.67772000749054,6,17.1388396631698,3,25.8428823581821,4,1,"rope",2,19.1651623506916
9.65119254233983,6,23.0574565665522,1,39.1234174038203,9,1,"rope",3,29.4722248614805
0.929028508253396,7,3.43237379072725,3,7.77034127685831,10,1,"rope",3,6.84131276860491
3.82619095657762,7,46.309664202213,5,48.5354797069546,4,1,"rope",3,44.709288750377
6.09050743594265,7,46.309664202213,5,47.5092104723309,5,1,"rope",2,41.4187030363883
2.89617654232585,8,3.41205477054211,5,17.2550400157016,1,1,"rope",7,14.3588634733757
5.02604293933415,8,11.2079710567531,3,17.1388396631698,6,1,"rope",2,12.1127967238357
5.36509383425985,8,11.2079710567531,3,20.0119760001825,5,1,"rope",3,14.6468821659226
6.73003302238194,9,10.4041400042836,3,28.8361340131861,3,1,"rope",6,22.1061009908042
7.4955024194897,9,10.4041400042836,3,34.0345640061352,1,1,"rope",8,26.5390615866455
8.77001378346789,9,10.4041400042836,3,17.1388396631698,6,1,"rope",3,8.36882587970191
9.95538325391647,10,40.8096177441548,5,46.309664202213,7,1,"rope",3,36.3542809482965
11.4037011955051,10,40.8096177441548,5,51.4220885785951,2,1,"rope",8,40.01838738309
13.6231814079725,10,40.8096177441548,5,46.309664202213,7,1,"rope",3,32.6864827942405
0.0515322666615248,1,1,1,6.59508110319793,4,1,"rope",3,6.5435488365364
0.94718335564704,1,1,1,19.8059647587641,10,1,"rope",9,18.8587814031171
1.40254518944294,1,10.5537966848304,4,14.7036042884422,3,1,"rope",2,13.3010590989993
1.76629753918843,1,10.5537966848304,4,14.7036042884422,3,1,"rope",2,12.9373067492538
2.15360204778136,1,10.5537966848304,4,31.8397847835324,9,1,"rope",8,29.686182735751
3.09046796980294,1,10.5537966848304,4,29.8884747902406,7,1,"rope",6,26.7980068204377
3.44290335561129,1,10.5537966848304,4,31.8397847835324,9,1,"rope",8,28.3968814279211
4.9234383709911,1,10.5537966848304,4,36.4233746290069,10,1,"rope",9,31.4999362580158
4.93977203968879,1,10.5537966848304,4,26.3188755901137,5,1,"rope",4,21.3791035504249
5.74907960742203,1,10.5537966848304,4,27.1456874585013,6,1,"rope",5,21.3966078510793
0.559543574694544,2,1.27583569194815,1,12.0441667172628,6,1,"rope",4,11.4846231425683
1.55711846561627,2,40.3973687882295,5,58.5648415399234,6,1,"rope",4,57.0077230743071
3.1496804965331,2,40.3973687882295,5,69.1766872345942,8,1,"rope",6,66.0270067380611
3.51465826143015,2,40.3973687882295,5,50.9199497929955,4,1,"rope",2,47.4052915315654
4.47787742638866,2,40.3973687882295,5,53.4923097290563,5,1,"rope",3,49.0144323026676
4.87148388486405,2,40.3973687882295,5,66.8320355876029,7,1,"rope",5,61.9605517027389
5.22277907572736,2,40.3973687882295,5,50.9199497929955,4,1,"rope",2,45.6971707172681
6.84560013258904,2,40.3973687882295,5,53.4923097290563,5,1,"rope",3,46.6467095964673
7.1472621566996,2,40.3973687882295,5,58.5648415399234,6,1,"rope",4,51.4175793832238
7.37341413296834,2,40.3973687882295,5,50.9199497929955,4,1,"rope",2,43.5465356600272
0.802320949113889,3,2.21411579195103,1,19.8059647587641,10,1,"rope",7,19.0036438096502
1.12812782343008,3,2.21411579195103,1,15.3225301324128,8,1,"rope",5,14.1944023089827
3.81240214472603,3,12.6846564439309,2,30.7719150169732,10,1,"rope",7,26.9595128722472
4.82546655303946,3,12.6846564439309,2,14.0705679864341,5,1,"rope",2,9.24510143339464
5.679237876155,3,12.6846564439309,2,18.4004679769213,9,1,"rope",6,12.7212301007663
6.18034130807272,3,12.6846564439309,2,18.4004679769213,9,1,"rope",6,12.2201266688486
6.64199263143591,3,12.6846564439309,2,14.0705679864341,5,1,"rope",2,7.42857535499819
7.16094893316976,3,12.6846564439309,2,16.1101477438985,7,1,"rope",4,8.94919881072874
7.75420627717972,3,27.3584166670405,5,30.821437154827,1,1,"rope",2,23.0672308776473
9.54055945169273,3,12.6846564439309,2,15.4454819365123,6,1,"rope",3,5.90492248481957
6.3043919575394,4,19.0518858406581,5,29.6097068659265,2,1,"rope",2,23.3053149083871
8.83895456128033,4,19.0518858406581,5,29.6097068659265,2,1,"rope",2,20.7707523046462
8.85343964169634,4,57.0433206365089,4,65.8647516143425,7,1,"rope",3,57.0113119726462
4.2524247553041,5,10.6991961148604,1,15.3225301324128,8,1,"rope",3,11.0701053771087
10.3334515160189,5,14.246417417922,5,27.3584166670405,3,1,"rope",2,17.0249651510216
18.6211509678897,5,38.2871805922074,1,42.8241868021072,2,1,"rope",3,24.2030358342175
1.12342607385168,6,10.0235827000489,5,19.0518858406581,4,1,"rope",2,17.9284597668064
9.60176066298249,6,58.5648415399234,5,73.277548442927,10,1,"rope",4,63.6757877799445
9.98857233010443,6,58.5648415399234,5,70.9881965868747,9,1,"rope",3,60.9996242567703
1.53395009847979,7,8.18549350822923,5,14.246417417922,5,1,"rope",2,12.7124673194422
2.28359055860589,7,3.69701257672501,3,13.8569668836355,9,1,"rope",2,11.5733763250296
2.82785562491801,7,8.18549350822923,5,19.0518858406581,4,1,"rope",3,16.2240302157401
4.52346056996191,8,6.27495144841201,5,30.821437154827,1,1,"rope",7,26.2979765848651
18.5033117767257,8,27.051096363032,1,42.2836292525393,3,1,"rope",5,23.7803174758136
19.1274800202954,8,27.051096363032,1,32.9042410527038,6,1,"rope",2,13.7767610324084
6.37422881992467,9,23.0368716904958,1,45.117017053696,1,1,"rope",8,38.7427882337713
9.15598987870129,9,23.0368716904958,1,32.3527856591904,7,1,"rope",2,23.1967957804891
10.4062107014925,9,23.0368716904958,1,42.8241868021072,2,1,"rope",7,32.4179761006147
5.07721372372323,10,23.9102139503614,3,52.6879662731501,2,1,"rope",8,47.6107525494269
6.18210512481793,10,23.9102139503614,3,52.6879662731501,2,1,"rope",8,46.5058611483322
7.05576224831406,10,23.9102139503614,3,44.1208908057354,6,1,"rope",4,37.0651285574213
0.180089667905122,1,1,1,17.9230520790304,5,1,"rope",4,17.7429624111253
0.616007359698415,1,1,1,34.2948382318637,10,1,"rope",9,33.6788308721653
1.46244296893002,1,10.6553266305001,2,18.3510862605141,4,1,"rope",3,16.8886432915841
3.06433190858427,1,10.6553266305001,2,33.6274497890065,9,1,"rope",8,30.5631178804222
5.74454026550926,1,10.6553266305001,2,32.0370210588827,8,1,"rope",7,26.2924807933734
6.58786588970968,1,10.6553266305001,2,18.3510862605141,4,1,"rope",3,11.7632203708044
7.0556232097412,1,10.6553266305001,2,13.659080426224,3,1,"rope",2,6.6034572164828
7.36275800940045,1,10.6553266305001,2,28.1879985088595,7,1,"rope",6,20.825240499459
8.22252080649058,1,10.6553266305001,2,28.1879985088595,7,1,"rope",6,19.9654777023689
8.9618675221841,1,10.6553266305001,2,13.659080426224,3,1,"rope",2,4.6972129040399
0.661172579042614,2,4.29409548259582,1,16.4591964052852,4,1,"rope",2,15.7980238262426
1.07103205891326,2,4.29409548259582,1,23.7033327104215,7,1,"rope",5,22.6323006515082
1.30857355939224,2,4.29409548259582,1,16.4591964052852,4,1,"rope",2,15.150622845893
2.31603886757812,2,4.29409548259582,1,16.4591964052852,4,1,"rope",2,14.1431575377071
7.46507097018182,2,15.2275133683393,5,20.0286000136027,7,1,"rope",5,12.5635290434209
8.1784852830854,2,15.2275133683393,5,20.0286000136027,7,1,"rope",5,11.8501147305173
8.26460503685966,2,15.2275133683393,5,18.5821604154919,5,1,"rope",3,10.3175553786322
12.5324129561397,2,15.2275133683393,5,18.5821604154919,5,1,"rope",3,6.0497474593522
13.1426188220704,2,15.2275133683393,5,21.5567128337286,8,1,"rope",6,8.4140940116582
15.3678767867492,2,25.6498006547409,4,29.8327156525959,4,1,"rope",2,14.4648388658467
0.933698552517176,3,28.0837647402116,4,36.4936253436516,10,1,"rope",7,35.5599267911344
1.37036297921646,3,28.0837647402116,4,33.2911027792888,9,1,"rope",6,31.9207398000723
2.33775704149236,3,7.45147369235474,5,13.1713679299827,1,1,"rope",2,10.8336108884903
2.7514827448856,3,28.0837647402116,4,30.462937836493,6,1,"rope",3,27.7114550916074
3.43576893973909,3,7.45147369235474,5,13.1713679299827,1,1,"rope",2,9.73559899024361
4.12612933870218,3,28.0837647402116,4,31.6403871371688,7,1,"rope",4,27.5142577984666
5.376932469339,3,28.0837647402116,4,36.4936253436516,10,1,"rope",7,31.1166928743126
6.87000959131356,3,28.0837647402116,4,36.4936253436516,10,1,"rope",7,29.623615752338
8.09027288894114,3,28.0837647402116,4,36.4936253436516,10,1,"rope",7,28.4033524547105
10.7417523323503,3,31.2979900675897,3,34.0621543080835,1,1,"rope",2,23.3204019757332
0.760007561323371,4,16.4591964052852,1,23.7033327104215,7,1,"rope",3,22.9433251490981
7.25711783845763,4,16.4591964052852,1,29.1227939465979,8,1,"rope",4,21.8656761081403
7.6806652761826,4,31.1951311094292,3,34.0621543080835,1,1,"rope",3,26.3814890319009
7.71985933262758,5,40.1558728466448,5,46.4398499262258,2,1,"rope",3,38.7199905935982
7.99875602514696,5,40.1558728466448,5,49.5080070633505,1,1,"rope",4,41.5092510382035
14.6127808688875,5,18.5821604154919,5,23.4221629992516,9,1,"rope",4,8.8093821303641
2.07442046453555,6,4.99521881566597,5,7.45147369235474,3,1,"rope",3,5.37705322781919
2.81126589048654,6,19.7643756779757,5,27.40655213989,10,1,"rope",4,24.5952862494035
2.94045544451192,6,4.99521881566597,5,10.1208295678297,2,1,"rope",4,7.18037412331778
4.73666337601153,7,20.0286000136027,5,23.4221629992516,9,1,"rope",2,18.6854996232401
4.95010171497689,7,20.0286000136027,5,27.40655213989,10,1,"rope",3,22.4564504249131
15.788301121279,7,37.0944054900187,5,43.1505882004158,4,1,"rope",3,27.3622870791368
0.134431090071978,8,3.1636297952084,5,6.67672645628234,4,1,"rope",4,6.54229536621036
5.49490823431141,8,19.6783410742647,3,34.0621543080835,1,1,"rope",7,28.5672460737721
6.07675529105789,8,19.6783410742647,3,34.0621543080835,1,1,"rope",7,27.9853990170256
0.516398381482273,9,2.00442517694813,5,3.84767252137304,7,1,"rope",2,3.33127413989077
8.97296030036393,9,18.2712295054604,3,34.0621543080835,1,1,"rope",8,25.0891940077196
16.6812860150585,9,18.2712295054604,3,30.4175873257535,5,1,"rope",4,13.736301310695
0.951421375696858,10,1,5,13.1713679299827,1,1,"rope",9,12.2199465542858
1.5299207599296,10,17.1080552433126,3,31.2979900675897,3,1,"rope",7,29.7680693076601
8.80843234244805,10,17.1080552433126,3,19.6783410742647,8,1,"rope",2,10.8699087318167
1.79836632675471,1,6.23597001304604,2,17.7056654982802,6,1,"rope",5,15.9072991715255
1.93794936259257,1,6.23597001304604,2,14.4510508785585,4,1,"rope",3,12.5131015159659
3.05877376940537,1,6.23597001304604,2,17.7056654982802,6,1,"rope",5,14.6468917288748
3.63727554500065,1,6.23597001304604,2,12.7993306166818,3,1,"rope",2,9.16205507168115
6.79022807591547,1,21.3239348414824,4,50.0510981712489,7,1,"rope",6,43.2608700953334
6.89696370447938,1,21.3239348414824,4,41.1129675773051,5,1,"rope",4,34.2160038728257
7.45267967474391,1,21.3239348414824,4,55.493229559852,9,1,"rope",8,48.0405498851081
9.49050659645073,1,21.3239348414824,4,59.3130288194001,10,1,"rope",9,49.8225222229494
12.197035202218,1,21.3239348414824,4,54.9774658330448,8,1,"rope",7,42.7804306308268
12.9803108474022,1,21.3239348414824,4,34.3661125766759,4,1,"rope",3,21.3858017292737
0.268884005650868,2,1.12904175650328,1,14.8099405127019,4,1,"rope",2,14.541056507051
0.292083210937669,2,1.12904175650328,1,17.2720844740695,6,1,"rope",4,16.9800012631318
1.60772994777829,2,11.3769705312318,2,24.8578497650228,9,1,"rope",7,23.2501198172445
1.850394922011,2,11.3769705312318,2,24.466646697478,8,1,"rope",6,22.616251775467
4.33768879672988,2,11.3769705312318,2,15.335403873972,5,1,"rope",3,10.9977150772421
4.38352806542933,2,11.3769705312318,2,27.5707352232917,10,1,"rope",8,23.1872071578624
4.48306131831303,2,35.7866080167724,5,61.3511695914278,8,1,"rope",6,56.8681082731148
5.60672564430551,2,35.7866080167724,5,64.4591859552721,10,1,"rope",8,58.8524603109666
7.17921514612991,2,35.7866080167724,5,55.8084810238635,7,1,"rope",5,48.6292658777336
10.413262171404,2,35.7866080167724,5,55.8084810238635,7,1,"rope",5,45.3952188524595
0.0243922207706549,3,6.61393749992248,1,31.3915941044458,10,1,"rope",7,31.3672018836751
0.775134981215546,3,6.61393749992248,1,30.9896662308371,9,1,"rope",6,30.2145312496216
1.18482292124684,3,6.61393749992248,1,17.2720844740695,6,1,"rope",3,16.0872615528227
1.62757828244009,3,6.61393749992248,1,31.3915941044458,10,1,"rope",7,29.7640158220057
5.96966242884396,3,6.01699535730505,4,11.6321006502496,1,1,"rope",2,5.66243822140564
6.92990387693614,3,38.6316725073879,5,64.4591859552721,10,1,"rope",7,57.529282078336
6.98020621153161,3,38.6316725073879,5,63.2952545781099,9,1,"rope",6,56.3150483665783
8.12456340754495,3,38.6316725073879,5,55.8084810238635,7,1,"rope",4,47.6839176163186
8.81684471566321,3,38.6316725073879,5,50.1552880835781,6,1,"rope",3,41.3384433679149
9.04524096271865,3,43.152517543944,3,58.8977374045176,10,1,"rope",7,49.8524964417989
12.3478378534766,4,20.8624925818131,5,28.5185672995836,1,1,"rope",3,16.170729446107
12.7916968653428,4,43.7098795236344,3,54.8564637720933,8,1,"rope",4,42.0647669067505
12.9115674383266,4,20.8624925818131,5,28.5185672995836,1,1,"rope",3,15.606999861257
2.2773126900817,5,44.4221250929194,3,58.8977374045176,10,1,"rope",5,56.6204247144359
3.20814013636361,5,13.2417831663355,5,28.5185672995836,1,1,"rope",4,25.31042716322
4.89515771974846,5,13.2417831663355,5,28.5185672995836,1,1,"rope",4,23.6234095798351
11.5241521342955,6,17.7056654982802,2,27.5707352232917,10,1,"rope",4,16.0465830889962
11.6100817873187,6,40.5130750459963,2,45.4752756656453,3,1,"rope",3,33.8651938783266
16.0865040014384,6,17.7056654982802,2,24.8578497650228,9,1,"rope",3,8.7713457635844
0.484965266674344,7,7.86295821294288,5,28.5185672995836,1,1,"rope",6,28.0336020329093
13.6025000015247,7,37.7019490741447,2,46.5344557799963,2,1,"rope",5,32.9319557784716
14.8001739453497,7,37.7019490741447,2,43.599290913913,4,1,"rope",3,28.7991169685633
0.963834947906435,8,4.4005965852843,5,13.2417831663355,5,1,"rope",3,12.2779482184291
3.16773113484184,8,4.4005965852843,5,13.2417831663355,5,1,"rope",3,10.0740520314937
8.26227938728341,8,16.8479502701448,3,24.27982145818,3,1,"rope",5,16.0175420708966
0.211414285370696,9,1.59291553590447,5,10.5392376969204,6,1,"rope",3,10.3278234115497
4.16259247211419,9,16.3403529696964,3,24.27982145818,3,1,"rope",6,20.1172289860658
4.63060571284414,9,16.3403529696964,3,26.4097822474237,2,1,"rope",7,21.7791765345796
2.19506576657295,10,14.8613581442728,3,22.1427943457154,5,1,"rope",5,19.9477285791425
8.95085521014341,10,14.8613581442728,3,20.1224506505793,7,1,"rope",3,11.1715954404359
9.13645786826122,10,14.8613581442728,3,26.4097822474237,2,1,"rope",8,17.2733243791625
0.0208727720045279,1,1,1,9.46136871170538,4,1,"rope",3,9.44049593970085
3.02973242858765,1,6.45864939114039,2,25.3648958443409,5,1,"rope",4,22.3351634157533
4.48498878256738,1,6.45864939114039,2,29.5364941917841,7,1,"rope",6,25.0515054092167
4.60525104317539,1,6.45864939114039,2,25.3648958443409,5,1,"rope",4,20.7596448011655
4.63863584918627,1,6.45864939114039,2,29.5364941917841,7,1,"rope",6,24.8978583425978
5.1366751469458,1,6.45864939114039,2,19.0649212679063,3,1,"rope",2,13.9282461209605
5.20627130947732,1,6.45864939114039,2,29.5364941917841,7,1,"rope",6,24.3302228823068
5.98678483593835,1,6.45864939114039,2,25.3648958443409,5,1,"rope",4,19.3781110084025
8.69863433344351,1,24.4210269047087,5,38.3386342597142,6,1,"rope",5,29.6399999262707
8.91809910768705,1,24.4210269047087,5,49.7835634074366,9,1,"rope",8,40.8654642997496
0.934093723978823,2,3.48462902056545,1,9.46136871170538,4,1,"rope",2,8.52727498772656
1.70508530915423,2,3.48462902056545,1,21.2687561534083,9,1,"rope",7,19.5636708442541
2.72910349153146,2,3.48462902056545,1,26.1887316060033,10,1,"rope",8,23.4596281144718
4.77169769703555,2,25.7638245944391,5,45.0312551829883,8,1,"rope",6,40.2595574859528
6.2465337893938,2,25.7638245944391,5,41.8111053117986,7,1,"rope",5,35.5645715224048
6.4020176824494,2,25.7638245944391,5,45.0312551829883,8,1,"rope",6,38.6292375005389
6.55688782733213,2,25.7638245944391,5,51.7950072036991,10,1,"rope",8,45.238119376367
9.11695809787854,2,25.7638245944391,5,35.7993304883918,4,1,"rope",2,26.6823723905133
9.65877571501553,2,25.7638245944391,5,35.7993304883918,4,1,"rope",2,26.1405547733763
10.1096705806886,2,25.7638245944391,5,45.0312551829883,8,1,"rope",6,34.9215846022997
0.529884834308177,3,6.19814639928125,1,13.1215762669888,5,1,"rope",2,12.5916914326806
2.36663604379612,3,6.19814639928125,1,19.6205101279532,8,1,"rope",5,17.2538740841571
3.28555938914854,3,6.19814639928125,1,18.9758610585645,7,1,"rope",4,15.690301669416
4.06027915293407,3,6.19814639928125,1,19.6205101279532,8,1,"rope",5,15.5602309750191
5.10903231573803,3,20.2031719171357,4,32.8607432212811,10,1,"rope",7,27.7517109055431
7.50620858580089,3,11.813911458155,5,16.1951159065736,1,1,"rope",2,8.68890732077271
8.92596418370064,3,20.2031719171357,4,32.8607432212811,10,1,"rope",7,23.9347790375805
9.46643352747466,3,20.2031719171357,4,26.0929826040792,7,1,"rope",4,16.6265490766045
10.3239994229448,3,20.2031719171357,4,32.0657737610202,9,1,"rope",6,21.7417743380754
10.5618840632587,3,20.2031719171357,4,25.0727081496365,6,1,"rope",3,14.5108240863778
4.87395115168699,4,47.4020436589542,3,56.5638720130161,7,1,"rope",3,51.6899208613291
5.90998470423714,4,47.4020436589542,3,53.4041762799152,6,1,"rope",2,47.4941915756781
6.11771945637311,4,9.47780597239089,5,14.7584841540255,2,1,"rope",2,8.64076469765239
1.51230789671298,5,25.3648958443409,2,36.0933427508792,9,1,"rope",4,34.5810348541662
5.2045113567112,5,25.3648958443409,2,29.5364941917841,7,1,"rope",2,24.3319828350729
9.88041436630278,5,49.616429973117,3,60.3596711979539,9,1,"rope",4,50.4792568316511
0.553676369599998,6,2.97041183887961,3,14.6398276393421,10,1,"rope",4,14.0861512697421
6.97402959195831,6,8.1262182829291,5,14.7584841540255,2,1,"rope",4,7.78445456206719
12.492008061209,6,25.4349476648185,3,31.2449984326889,2,1,"rope",4,18.7529903714799
3.3154268406173,7,7.34353525956156,5,14.7584841540255,2,1,"rope",5,11.4430573134082
6.91755484652177,7,26.0929826040792,4,32.8607432212811,10,1,"rope",3,25.9431883747593
9.8286177668478,7,25.2816252815526,3,31.2449984326889,2,1,"rope",5,21.4163806658411
4.0292398474952,8,5.72311189336107,5,11.813911458155,3,1,"rope",5,7.7846716106598
6.30205325768296,8,36.305570706274,1,52.3875190841055,1,1,"rope",7,46.0854658264225
7.52123700906489,8,36.305570706274,1,49.6098560260889,2,1,"rope",6,42.088619017024
0.421068592307468,9,1.57971663959324,5,11.813911458155,3,1,"rope",6,11.3928428658475
2.17978740731875,9,21.8792382039259,3,31.2449984326889,2,1,"rope",7,29.0652110253702
5.21742715796733,9,21.8792382039259,3,25.4349476648185,6,1,"rope",3,20.2175205068512
4.77427120602934,10,20.0106655961956,3,23.9884400939789,8,1,"rope",2,19.2141688879496
5.67066814518748,10,20.0106655961956,3,25.4349476648185,6,1,"rope",4,19.764279519631
7.6581691151289,10,20.0106655961956,3,29.7837016580324,4,1,"rope",6,22.1255325429035
0.752411687704635,1,1,1,15.0245723397944,6,1,"rope",5,14.2721606520898
1.24654548750715,1,6.79890377360594,2,34.9289021042089,10,1,"rope",9,33.6823566167018
1.454364062171,1,6.79890377360594,2,9.95771790982735,3,1,"rope",2,8.50335384765635
2.50891478623304,1,6.79890377360594,2,15.2045115525711,5,1,"rope",4,12.6955967663381
3.22866760685948,1,6.79890377360594,2,16.1911772814395,6,1,"rope",5,12.96250967458
3.41181382032197,1,6.79890377360594,2,9.95771790982735,3,1,"rope",2,6.54590408950538
3.75951163152319,1,6.79890377360594,2,26.3382297887598,8,1,"rope",7,22.5787181572366
4.41145648814824,1,6.79890377360594,2,26.3382297887598,8,1,"rope",7,21.9267733006116
4.52229618722891,1,6.79890377360594,2,29.9220102520622,9,1,"rope",8,25.3997140648333
4.82423288866691,1,6.79890377360594,2,15.2045115525711,5,1,"rope",4,10.3802786639042
0.684774168301374,2,5.96943338162833,1,25.2377617032361,9,1,"rope",7,24.5529875349347
1.85329539371179,2,5.96943338162833,1,12.321020320975,5,1,"rope",3,10.4677249272632
2.34949729214878,2,5.96943338162833,1,15.0245723397944,6,1,"rope",4,12.6750750476456
2.49346649863768,2,5.96943338162833,1,26.5826404174469,10,1,"rope",8,24.0891739188092
3.03118556070153,2,5.96943338162833,1,26.5826404174469,10,1,"rope",8,23.5514548567454
5.4305724374267,2,17.2712933587623,4,29.7240486181702,6,1,"rope",4,24.2934761807435
6.58262144521024,2,17.2712933587623,4,31.7077532879185,7,1,"rope",5,25.1251318427083
8.48584647215097,2,17.2712933587623,4,29.7240486181702,6,1,"rope",4,21.2382021460192
8.74404787150337,2,17.2712933587623,4,25.1579485451319,4,1,"rope",2,16.4139006736285
10.1146567563026,2,17.2712933587623,4,31.7077532879185,7,1,"rope",5,21.5930965316159
0.246241589597982,3,34.5365619996774,3,50.3340419789556,8,1,"rope",5,50.0878003893576
1.34732863913708,3,34.5365619996774,3,46.0914240088606,6,1,"rope",3,44.7440953697235
6.18221836746097,3,34.5365619996774,3,47.5012632719071,7,1,"rope",4,41.3190449044461
7.84271512262248,3,34.5365619996774,3,56.7249574038033,10,1,"rope",7,48.8822422811808
9.55080344735697,3,34.5365619996774,3,43.5475744081862,5,1,"rope",2,33.9967709608292
9.9202010941045,3,34.5365619996774,3,43.5475744081862,5,1,"rope",2,33.6273733140817
10.3560769117722,3,34.5365619996774,3,50.3340419789556,8,1,"rope",5,39.9779650671834
10.4587252361053,3,18.8709373212075,5,31.5442909328492,1,1,"rope",2,21.0855656967439
10.7450169941695,3,18.8709373212075,5,31.5442909328492,1,1,"rope",2,20.7992739386797
11.7850022150068,3,34.5365619996774,3,56.7249574038033,10,1,"rope",7,44.9399551887965
2.11022429168224,4,41.9923922057448,5,45.7329119645888,6,1,"rope",2,43.6226876729066
5.87820189991001,4,41.9923922057448,5,49.8097868277913,9,1,"rope",5,43.9315849278813
12.5844822478315,4,23.1211362522267,3,26.0408467385036,2,1,"rope",2,13.4563644906721
3.18052456828123,5,26.6785489277199,4,40.6164257424435,9,1,"rope",4,37.4359011741623
7.15539930798679,5,26.6785489277199,4,36.8117446831458,8,1,"rope",3,29.656345375159
15.7156445618032,5,26.6785489277199,4,31.7077532879185,7,1,"rope",2,15.9921087261153
0.92064575117704,6,11.4376032100534,5,16.8400150349271,4,1,"rope",2,15.9193692837501
8.14149241307575,6,11.4376032100534,5,25.7344391809418,2,1,"rope",4,17.592946767866
8.84047484059332,6,15.0245723397944,1,26.5826404174469,10,1,"rope",4,17.7421655768536
0.435239310849783,7,10.4729216014044,5,18.8709373212075,3,1,"rope",4,18.4356980103577
8.97494316509982,7,10.4729216014044,5,18.8709373212075,3,1,"rope",4,9.89599415610768
11.0308911925094,7,21.232670704828,3,23.9310803247379,3,1,"rope",4,12.9001891322285
9.59084489993606,8,19.3842223683117,3,23.0036773438737,5,1,"rope",3,13.4128324439376
12.7413753014133,8,19.3842223683117,3,26.0408467385036,2,1,"rope",6,13.2994714370903
18.4089903807647,8,26.3382297887598,2,34.9289021042089,10,1,"rope",2,16.5199117234442
0.185550573902826,9,4.65463245270734,5,10.4729216014044,7,1,"rope",2,10.2873710275016
2.33685492072254,9,4.65463245270734,5,14.5722169888719,5,1,"rope",4,12.2353620681494
2.71336841757937,9,4.65463245270734,5,31.5442909328492,1,1,"rope",8,28.8309225152698
12.5683558166476,10,13.5110490642546,3,23.0036773438737,5,1,"rope",5,10.4353215272261
15.0158885641367,10,29.7221548013255,1,36.7397783911159,5,1,"rope",5,21.7238898269792
21.7543836143006,10,29.7221548013255,1,41.1013171073913,2,1,"rope",8,19.3469334930907
0.523983996827155,1,1,1,23.6011347439709,10,1,"rope",9,23.0771507471437
5.25753200075529,1,8.98047478442443,2,18.3919158000223,3,1,"rope",2,13.134383799267
6.11128591259117,1,8.98047478442443,2,29.6742597991897,7,1,"rope",6,23.5629738865985
8.92932733313052,1,14.6786088248013,4,43.4070875272717,9,1,"rope",8,34.4777601941412
8.97625721783248,1,14.6786088248013,4,32.6670631606972,5,1,"rope",4,23.6908059428647
10.0034209785271,1,14.6786088248013,4,35.5804035072033,6,1,"rope",5,25.5769825286762
10.0190920315615,1,14.6786088248013,4,27.4060719739978,4,1,"rope",3,17.3869799424363
10.033023974922,1,14.6786088248013,4,26.7828969231374,3,1,"rope",2,16.7498729482154
10.2296141721033,1,14.6786088248013,4,39.5216676685261,7,1,"rope",6,29.2920534964228
10.919409623342,1,14.6786088248013,4,26.7828969231374,3,1,"rope",2,15.8634872997954
0.101232885848679,2,3.52749260389164,1,21.9054073362753,9,1,"rope",7,21.8041744504266
4.63579084279882,2,10.5478846034024,2,35.9664064701164,10,1,"rope",8,31.3306156273176
5.61113617389524,2,10.5478846034024,2,29.6742597991897,7,1,"rope",5,24.0631236252945
6.05622757023,2,10.5478846034024,2,35.9664064701164,10,1,"rope",8,29.9101788998864
6.63499214110695,2,10.5478846034024,2,19.6163817238298,4,1,"rope",2,12.9813895827229
6.83132558235227,2,10.5478846034024,2,35.9664064701164,10,1,"rope",8,29.1350808877641
10.6280314446495,2,33.9756434577135,5,48.5463912201556,8,1,"rope",6,37.9183597755061
10.6580904283628,2,33.9756434577135,5,50.1561660840697,10,1,"rope",8,39.4980756557069
10.6811133896343,2,33.9756434577135,5,35.84015665175,4,1,"rope",2,25.1590432621157
12.0298328681771,2,33.9756434577135,5,47.320083571448,7,1,"rope",5,35.2902507032709
1.45733310578773,3,11.3670840274157,1,16.6103258170929,7,1,"rope",4,15.1529927113052
2.12757247936363,3,11.3670840274157,1,23.6011347439709,10,1,"rope",7,21.4735622646073
2.48905473638708,3,11.3670840274157,1,15.2844177155529,5,1,"rope",2,12.7953629791658
3.38426794264372,3,11.3670840274157,1,23.6011347439709,10,1,"rope",7,20.2168668013272
3.76575134660955,3,6.37351064134349,4,11.543981984698,1,1,"rope",2,7.77823063808845
4.88675235769474,3,11.3670840274157,1,16.6103258170929,7,1,"rope",4,11.7235734593982
5.44435312737473,3,11.3670840274157,1,15.6783521552344,6,1,"rope",3,10.2339990278597
5.47827621107285,3,11.3670840274157,1,15.2844177155529,5,1,"rope",2,9.80614150448005
5.9592711271282,3,11.3670840274157,1,21.9054073362753,9,1,"rope",6,15.9461362091471
8.71413600036674,3,11.3670840274157,1,15.6783521552344,6,1,"rope",3,6.96421615486766
4.49510323180163,4,35.84015665175,5,50.1561660840697,10,1,"rope",6,45.6610628522681
10.9307528003575,4,17.6055907791259,5,26.0074808749772,1,1,"rope",3,15.0767280746197
12.2793980155906,4,35.84015665175,5,48.5463912201556,8,1,"rope",4,36.266993204565
0.418696896854967,5,1,4,9.974053423384,2,1,"rope",3,9.55535652652903
3.84780599075851,5,32.6670631606972,4,44.0395799361958,10,1,"rope",5,40.1917739454373
4.67034888104396,5,32.6670631606972,4,44.0395799361958,10,1,"rope",5,39.3692310551518
0.238293995875072,6,3.00347466184747,3,8.63243513067669,10,1,"rope",4,8.39414113480162
1.02735835870885,6,3.00347466184747,3,6.45122741280933,8,1,"rope",2,5.42386905410048
7.3914072084257,6,41.3093360611473,3,44.7545249277345,8,1,"rope",2,37.3631177193088
5.58756367621873,7,13.2985527535722,5,17.6055907791259,4,1,"rope",3,12.0180271029072
6.24481352715678,7,13.2985527535722,5,17.6055907791259,4,1,"rope",3,11.3607772519691
15.1751598778536,7,19.7427484896219,3,32.992404249241,1,1,"rope",6,17.8172443713874
1.38652167593439,8,9.75163992514057,5,17.6055907791259,4,1,"rope",4,16.2190691031915
5.64931890913252,8,9.75163992514057,5,13.6369786589934,5,1,"rope",3,7.98765974986088
10.546147018458,8,18.4054584744865,3,21.9683516592921,6,1,"rope",2,11.4222046408341
0.811460926197469,9,2.94009974741207,5,13.6369786589934,5,1,"rope",4,12.8255177327959
9.38012370458263,9,12.2678579645534,3,19.7427484896219,7,1,"rope",2,10.3626247850393
9.40767290783402,9,12.2678579645534,3,21.9683516592921,6,1,"rope",3,12.5606787514581
1.11118267612677,10,12.0750881869108,3,22.7089087869243,5,1,"rope",5,21.5977261107975
11.4261976108174,10,12.0750881869108,3,19.7427484896219,7,1,"rope",3,8.3165508788045
15.4907174754948,10,28.4338893099275,1,38.8237236209242,2,1,"rope",8,23.3330061454294
1.50514677125298,1,4.36419740393696,2,22.7568297803763,7,1,"rope",6,21.2516830091233
1.88205554963664,1,4.36419740393696,2,16.8945475365543,5,1,"rope",4,15.0124919869177
3.08321817190485,1,4.36419740393696,2,16.8945475365543,5,1,"rope",4,13.8113293646494
4.30252299424815,1,17.0402198577006,4,34.4630026823543,9,1,"rope",8,30.1604796881062
4.65450681247372,1,17.0402198577006,4,28.5112215720539,6,1,"rope",5,23.8567147595802
6.54137611627182,1,17.0402198577006,4,34.4630026823543,9,1,"rope",8,27.9216265660825
7.43531793992381,1,17.0402198577006,4,27.7270717256193,5,1,"rope",4,20.2917537856955
8.49978721528717,1,17.0402198577006,4,27.7270717256193,5,1,"rope",4,19.2272845103321
8.90978353158973,1,17.0402198577006,4,32.5185388466864,7,1,"rope",6,23.6087553150967
9.606578366467,1,17.0402198577006,4,21.6851536063408,3,1,"rope",2,12.0785752398738
0.19016660874637,2,5.84619461675148,2,24.5102162663259,10,1,"rope",8,24.3200496575795
2.11196430409512,2,5.84619461675148,2,15.7741138338619,4,1,"rope",2,13.6621495297668
2.45277293182113,2,5.84619461675148,2,22.7568297803763,7,1,"rope",5,20.3040568485552
4.82009125457716,2,5.84619461675148,2,17.5322044406594,6,1,"rope",4,12.7121131860822
5.22920511386928,2,6.92381812598477,1,20.2247824614365,7,1,"rope",5,14.9955773475672
10.6329835343364,2,30.4184633785548,5,43.9246800650035,9,1,"rope",7,33.2916965306671
11.855482841364,2,30.4184633785548,5,39.7521325466487,6,1,"rope",4,27.8966497052847
12.4566147890751,2,30.4184633785548,5,45.7119301255209,10,1,"rope",8,33.2553153364458
12.9194963397336,2,30.4184633785548,5,41.9776594163043,7,1,"rope",5,29.0581630765707
14.5245502878881,2,30.4184633785548,5,43.9246800650035,9,1,"rope",7,29.4001297771154
0.529808280058205,3,9.73749095606098,1,24.3493442417034,9,1,"rope",6,23.8195359616452
1.97474211941461,3,9.73749095606098,1,23.8045607945254,8,1,"rope",5,21.8298186751108
3.3550025375418,3,9.73749095606098,1,23.8045607945254,8,1,"rope",5,20.4495582569836
4.36264527136428,3,9.73749095606098,1,17.3863898163411,5,1,"rope",2,13.0237445449768
5.62278743655844,3,9.73749095606098,1,17.3863898163411,5,1,"rope",2,11.7636023797827
6.77434602011874,3,9.73749095606098,1,23.8045607945254,8,1,"rope",5,17.0302147744067
6.93132298471156,3,9.73749095606098,1,25.132328110971,10,1,"rope",7,18.2010051262594
9.47048718687333,3,13.7216926227442,5,23.4545900698737,1,1,"rope",2,13.9841028830004
9.92866581434804,3,41.3798310916837,3,46.9173254917854,5,1,"rope",2,36.9886596774374
12.0571686799413,3,41.3798310916837,3,49.338441491976,6,1,"rope",3,37.2812728120347
8.87573688559445,4,44.016428539823,3,52.5657273503683,8,1,"rope",4,43.6899904647738
11.7311741999546,4,44.016428539823,3,49.338441491976,6,1,"rope",2,37.6072672920214
13.2811814839526,4,44.016428539823,3,49.338441491976,6,1,"rope",2,36.0572600080234
1.18788312965383,5,71.5623368404729,1,73.1062255169916,7,1,"rope",2,71.9183423873378
3.0238879735892,5,9.353002453356,5,13.7216926227442,3,1,"rope",2,10.697804649155
4.49886572392037,5,71.5623368404729,1,73.1062255169916,7,1,"rope",2,68.6073597930712
3.33335816846196,6,17.5322044406594,2,24.5102162663259,10,1,"rope",4,21.1768580978639
3.75004231605335,6,17.5322044406594,2,24.0691841413005,9,1,"rope",3,20.3191418252472
5.92841245840891,6,17.5322044406594,2,24.5102162663259,10,1,"rope",4,18.581803807917
6.82303094587533,7,31.6397837874003,2,54.2675008980528,2,1,"rope",5,47.4444699521775
7.6660017930275,7,31.6397837874003,2,54.2675008980528,2,1,"rope",5,46.6014991050253
7.76919520715949,7,32.5185388466864,4,34.4630026823543,9,1,"rope",2,26.6938074751948
0.722357568839347,8,2.73747891760893,5,13.1142015758217,4,1,"rope",4,12.3918440069824
4.80114009030162,8,20.9127510615142,3,35.0426228324086,2,1,"rope",6,30.241482742107
5.25842482643822,8,20.9127510615142,3,33.0246909258079,4,1,"rope",4,27.7662660993697
0.644093942828476,9,1.73784836381674,5,9.353002453356,5,1,"rope",4,8.70890851052752
18.2970789546279,9,27.2940322776397,2,57.8796565166115,1,1,"rope",8,39.5825775619836
31.1864546448836,9,40.8054014078298,4,64.9197872946143,3,1,"rope",6,33.7333326497307
1.22434337157756,10,10.2285891523395,3,34.3811008139384,3,1,"rope",7,33.1567574423608
2.64834302787979,10,10.2285891523395,3,33.0246909258079,4,1,"rope",6,30.3763478979281
7.30192499280386,10,10.2285891523395,3,36.2974415589957,1,1,"rope",9,28.9955165661918
0.229469745885581,1,1,1,13.5063224958866,6,1,"rope",5,13.276852750001
0.656227224040776,1,1,1,8.93154727881988,3,1,"rope",2,8.2753200547791
1.77247196850823,1,12.0871979031263,4,31.9803949403112,9,1,"rope",8,30.207922971803
2.77299865000861,1,12.0871979031263,4,33.6976227525803,10,1,"rope",9,30.9246241025717
4.63887802727481,1,12.0871979031263,4,21.6247983587869,5,1,"rope",4,16.9859203315121
4.97939111554955,1,12.0871979031263,4,31.9803949403112,9,1,"rope",8,27.0010038247616
6.02533135448998,1,12.0871979031263,4,21.6247983587869,5,1,"rope",4,15.5994670042969
6.10898775167248,1,12.0871979031263,4,16.8258758925912,3,1,"rope",2,10.7168881409187
6.75579825953996,1,12.0871979031263,4,20.067872304347,4,1,"rope",3,13.312074044807
7.26026920999816,1,12.0871979031263,4,20.067872304347,4,1,"rope",3,12.8076030943488
0.557701739482582,2,4.09800771523156,1,14.2189400039181,7,1,"rope",5,13.6612382644355
4.98205965116484,2,19.2628312660005,2,28.2098680622795,5,1,"rope",3,23.2278084111147
4.99445581672741,2,19.2628312660005,2,36.5988051833249,8,1,"rope",6,31.6043493665975
5.99204447818472,2,19.2628312660005,2,31.5373768206129,6,1,"rope",4,25.5453323424282
10.5621815204849,2,19.2628312660005,2,23.9486561132269,4,1,"rope",2,13.386474592742
11.5757309702965,2,19.2628312660005,2,41.5761475978142,10,1,"rope",8,30.0004166275177
11.7833882240947,2,19.2628312660005,2,23.9486561132269,4,1,"rope",2,12.1652678891322
12.4288240020531,2,19.2628312660005,2,38.7715100105679,9,1,"rope",7,26.3426860085148
17.378459136769,2,19.2628312660005,2,34.4228383463464,7,1,"rope",5,17.0443792095774
17.6797869040852,2,19.2628312660005,2,28.2098680622795,5,1,"rope",3,10.5300811581943
1.3234026999724,3,15.2791869452533,5,22.8943305464297,1,1,"rope",2,21.5709278464573
1.38762223947997,3,8.93154727881988,1,19.4494584618095,9,1,"rope",6,18.0618362223295
2.58036208841678,3,8.93154727881988,1,10.7359609101741,5,1,"rope",2,8.15559882175732
3.53352267607299,3,8.93154727881988,1,14.2189400039181,7,1,"rope",4,10.6854173278451
4.7602703183022,3,8.93154727881988,1,25.4054100938843,10,1,"rope",7,20.6451397755821
6.78397180718989,3,8.93154727881988,1,16.4761347617613,8,1,"rope",5,9.69216295457141
7.95626449414673,3,15.2791869452533,5,22.8943305464297,1,1,"rope",2,14.938066052283
8.25518775328207,3,15.2791869452533,5,22.8943305464297,1,1,"rope",2,14.6391427931476
8.8066051597973,3,36.9530750770603,5,38.6914503377911,5,1,"rope",2,29.8848451779938
8.93662422106468,3,36.9530750770603,5,38.6914503377911,5,1,"rope",2,29.7548261167264
10.5351964130363,4,38.1126091218137,5,42.4234254287707,6,1,"rope",2,31.8882290157344
15.6895735091992,4,38.1126091218137,5,45.6991052544078,7,1,"rope",3,30.0095317452086
18.0010405162283,4,38.1126091218137,5,53.4002551219888,10,1,"rope",6,35.3992146057605
11.4264265442254,5,21.6247983587869,4,31.3091532138884,8,1,"rope",3,19.882726669663
15.0022923535806,5,21.6247983587869,4,26.8150348530849,7,1,"rope",2,11.8127424995043
21.0116200977447,5,22.8978500619551,3,25.1350661441012,2,1,"rope",3,4.1234460463565
0.677316804509754,6,10.349575732042,5,15.2791869452533,3,1,"rope",3,14.6018701407435
2.59150013274838,6,42.4234254287707,5,46.6728457538283,8,1,"rope",2,44.0813456210799
5.315431935424,6,10.349575732042,5,14.1582180838182,4,1,"rope",2,8.8427861483942
10.1725827896954,7,36.4679142321149,1,40.2681340317186,5,1,"rope",2,30.0955512420232
10.9417195410765,7,36.4679142321149,1,44.2089496839918,4,1,"rope",3,33.2672301429153
14.500488586955,7,36.4679142321149,1,40.2681340317186,5,1,"rope",2,25.7676454447636
8.82743776423447,8,19.860541028272,3,22.8978500619551,5,1,"rope",3,14.0704122977206
9.05571752428914,8,19.860541028272,3,29.3371371038598,1,1,"rope",7,20.2814195795707
9.53026538302903,8,19.860541028272,3,29.3371371038598,1,1,"rope",7,19.8068717208308
1.71364137592415,9,6.07407462199159,5,22.8943305464297,1,1,"rope",8,21.1806891705055
5.01225423985128,9,6.07407462199159,5,19.3448104571991,2,1,"rope",7,14.3325562173478
7.69148803908932,9,15.8000713146187,3,21.3431016708391,7,1,"rope",2,13.6516136317498
1.07946600467131,10,12.722531239575,3,21.806011785324,6,1,"rope",4,20.7265457806527
2.76134660480087,10,12.722531239575,3,25.1350661441012,2,1,"rope",8,22.3737195393003
9.96347202579555,10,12.722531239575,3,21.806011785324,6,1,"rope",4,11.8425397595284
0.406079894863069,1,1,1,16.4616811115092,7,1,"rope",6,16.0556012166461
1.87219533222708,1,8.82403691257251,2,26.6882391325812,10,1,"rope",9,24.8160438003541
2.11363326038072,1,8.82403691257251,2,24.9018795327897,8,1,"rope",7,22.788246272409
3.41813366135876,1,8.82403691257251,2,16.6310716576254,5,1,"rope",4,13.2129379962666
3.60081580115776,1,8.82403691257251,2,26.1432765552457,9,1,"rope",8,22.5424607540879
4.72267246914846,1,8.82403691257251,2,14.0569588863173,4,1,"rope",3,9.33428641716884
5.60335270113652,1,8.82403691257251,2,12.3441889236172,3,1,"rope",2,6.74083622248068
7.28618105849571,1,8.82403691257251,2,26.1432765552457,9,1,"rope",8,18.85709549675
8.68929653055181,1,9.98900276352916,4,21.8672173761079,7,1,"rope",6,13.1779208455561
8.80039353388508,1,9.98900276352916,4,23.2374319252768,9,1,"rope",8,14.4370383913917
0.256695441901684,2,6.00790975264214,1,11.6154083304796,5,1,"rope",3,11.3587128885779
0.376832588248858,2,6.00790975264214,1,19.4724503414579,8,1,"rope",6,19.095617753209
1.43751385917974,2,6.00790975264214,1,16.4616811115092,7,1,"rope",5,15.0241672523295
2.42111564149137,2,6.00790975264214,1,16.4616811115092,7,1,"rope",5,14.0405654700178
3.36722751144764,2,6.00790975264214,1,20.5619229159375,9,1,"rope",7,17.1946954044899
3.45249927311096,2,6.00790975264214,1,14.4373279868797,6,1,"rope",4,10.9848287137687
5.38198663180566,2,6.00790975264214,1,10.4075099396044,4,1,"rope",2,5.02552330779874
10.4814869169731,2,13.7201037289375,4,22.1790999447709,8,1,"rope",6,11.6976130277978
10.5805579963726,2,13.7201037289375,4,17.7231231608927,4,1,"rope",2,7.1425651645201
12.0198610568395,2,13.7201037289375,4,20.3114294979846,5,1,"rope",3,8.2915684411451
0.593870745506138,3,30.3469595443522,5,38.4463608749527,6,1,"rope",3,37.8524901294466
3.71700307104697,3,30.3469595443522,5,48.4397289572169,7,1,"rope",4,44.7227258861699
4.15503180149903,3,30.3469595443522,5,38.4463608749527,6,1,"rope",3,34.2913290734537
5.08252078972241,3,30.3469595443522,5,60.7470223438288,10,1,"rope",7,55.6645015541064
5.50676693067208,3,30.3469595443522,5,60.7470223438288,10,1,"rope",7,55.2402554131567
7.22648280123409,3,30.3469595443522,5,38.4463608749527,6,1,"rope",3,31.2198780737186
7.69802904511031,3,30.3469595443522,5,60.7470223438288,10,1,"rope",7,53.0489932987185
8.61121021775214,3,30.3469595443522,5,58.6555324573269,9,1,"rope",6,50.0443222395748
8.89213236333487,3,30.3469595443522,5,58.6555324573269,9,1,"rope",6,49.763400093992
8.98190256002549,3,30.3469595443522,5,38.4463608749527,6,1,"rope",3,29.4644583149272
1.95469996581475,4,54.0435219857622,3,74.4911409793162,10,1,"rope",6,72.5364410135014
2.00276898064961,4,13.1677598177624,5,18.2525614011466,1,1,"rope",3,16.249792420497
2.93129108225306,4,13.1677598177624,5,16.4038230815551,2,1,"rope",2,13.472531999302
0.00408165001620849,5,1,4,8.38013157621883,1,1,"rope",4,8.37604992620262
2.38018019576524,5,20.3114294979846,4,23.2374319252768,9,1,"rope",4,20.8572517295116
4.49285635865881,5,20.3114294979846,4,22.1790999447709,8,1,"rope",3,17.6862435861121
1.71295890118927,6,9.83330881004526,5,13.1677598177624,4,1,"rope",2,11.4548009165731
5.35411353640324,6,9.83330881004526,5,18.2525614011466,1,1,"rope",5,12.8984478647434
5.82702235021696,6,20.1002581940758,2,24.9018795327897,8,1,"rope",2,19.0748571825727
3.78123220973615,7,16.4616811115092,1,24.0562278345932,10,1,"rope",3,20.2749956248571
4.62178926776555,7,8.35214080728257,5,13.1677598177624,4,1,"rope",3,8.54597054999685
12.0290792529128,7,34.0243699974217,4,45.9576677858953,3,1,"rope",4,33.9285885329825
4.29033178822104,8,6.95728746836965,5,18.2525614011466,1,1,"rope",7,13.9622296129256
6.07504717525993,8,31.9421928575477,4,45.9576677858953,3,1,"rope",5,39.8826206106354
10.475713466014,8,31.9421928575477,4,41.8017364579994,5,1,"rope",3,31.3260229919854
2.42984088713745,9,26.3055674673584,3,41.3524369684991,2,1,"rope",7,38.9225960813616
7.53978693437884,9,26.3055674673584,3,31.5801793234569,6,1,"rope",3,24.0403923890781
15.5620018470786,9,26.3055674673584,3,41.3524369684991,2,1,"rope",7,25.7904351214205
3.18589692051405,10,19.2119360431805,3,43.2133407065404,1,1,"rope",9,40.0274437860264
16.3791989439698,10,19.2119360431805,3,31.5801793234569,6,1,"rope",4,15.2009803794871
18.3848198982176,10,19.2119360431805,3,28.5252930287423,8,1,"rope",2,10.1404731305247
0.104765262271276,1,1,1,18.7743881966773,8,1,"rope",7,18.669622934406
1.97875685590579,1,7.92197977917839,2,20.727822353773,6,1,"rope",5,18.7490654978672
4.30319349242138,1,7.92197977917839,2,31.6222625359403,9,1,"rope",8,27.3190690435189
4.4300723193048,1,7.92197977917839,2,17.9630294134023,5,1,"rope",4,13.5329570940975
4.62933350032523,1,7.92197977917839,2,31.6222625359403,9,1,"rope",8,26.9929290356151
11.0239384045243,1,14.782452021444,4,42.938893839327,10,1,"rope",9,31.9149554348027
11.5574590281002,1,14.782452021444,4,37.1947250418024,9,1,"rope",8,25.6372660137022
11.6833430567175,1,14.782452021444,4,35.7159729508716,8,1,"rope",7,24.0326298941541
12.0427575564362,1,14.782452021444,4,32.1821087647215,6,1,"rope",5,20.1393512082853
12.4884619271732,1,14.782452021444,4,37.1947250418024,9,1,"rope",8,24.7062631146292
3.5888545854607,2,9.0409768783501,2,15.4766274666677,4,1,"rope",2,11.887772881207
3.63864681745258,2,9.0409768783501,2,31.6222625359403,9,1,"rope",7,27.9836157184877
3.92415052807269,2,9.0409768783501,2,26.0479218930636,8,1,"rope",6,22.1237713649909
4.17124216417952,2,9.0409768783501,2,22.4032217733776,7,1,"rope",5,18.2319796091981
4.21123622360493,2,40.7497653958881,5,47.4185087645733,6,1,"rope",4,43.2072725409684
4.51701552600402,2,40.7497653958881,5,49.6289564889945,8,1,"rope",6,45.1119409629905
5.64035971824338,2,40.7497653958881,5,49.6289564889945,8,1,"rope",6,43.9885967707511
7.82482714368724,2,40.7497653958881,5,51.3231175980154,10,1,"rope",8,43.4982904543282
8.16447901696475,2,40.7497653958881,5,49.6289564889945,8,1,"rope",6,41.4644774720297
8.62017931294205,2,40.7497653958881,5,49.6289564889945,8,1,"rope",6,41.0087771760524
4.07874849976456,3,5.05781391525601,4,9.39135266922251,1,1,"rope",2,5.31260416945795
4.49097887591875,3,61.8763592678841,1,79.3285806217,9,1,"rope",6,74.8376017457812
4.60028353247564,3,61.8763592678841,1,79.9944862884565,10,1,"rope",7,75.3942027559809
4.86733148067962,3,61.8763592678841,1,66.971487779098,5,1,"rope",2,62.1041562984184
6.74190323984934,3,61.8763592678841,1,70.1478439659271,6,1,"rope",3,63.4059407260778
7.14603906697709,3,61.8763592678841,1,66.971487779098,5,1,"rope",2,59.8254487121209
7.22664847611565,3,61.8763592678841,1,70.1478439659271,6,1,"rope",3,62.9211954898114
7.38415715997672,3,61.8763592678841,1,78.0483348012882,8,1,"rope",5,70.6641776413115
8.16957676256996,3,61.8763592678841,1,79.3285806217,9,1,"rope",6,71.15900385913
8.80612207329821,3,61.8763592678841,1,79.3285806217,9,1,"rope",6,70.5224585484018
1.05808284599334,4,4.97009865065467,1,16.669808570874,7,1,"rope",3,15.6117257248807
1.1359270910422,4,4.97009865065467,1,18.7743881966773,8,1,"rope",4,17.6384611056351
16.5709893024507,4,64.0381321065486,3,77.6401897968723,10,1,"rope",6,61.0692004944216
4.33796616245334,5,10.4176125724271,1,18.7743881966773,8,1,"rope",3,14.436422034224
4.66944909295586,5,10.4176125724271,1,28.6303516435276,10,1,"rope",5,23.9609025505717
10.9828343110577,5,66.6781907926763,3,77.3035397596656,9,1,"rope",4,66.3207054486079
3.51943965055947,6,41.2798111102016,1,43.7558573275107,4,1,"rope",2,40.2364176769512
7.35391594441541,6,68.389268731473,3,77.6401897968723,10,1,"rope",4,70.2862738524569
8.53476454182587,6,68.389268731473,3,76.6252880316615,8,1,"rope",2,68.0905234898356
9.01925406687172,7,19.9271267304352,5,31.1074979368972,3,1,"rope",4,22.0882438700255
30.4769682494884,7,39.9156123906773,1,43.7558573275107,4,1,"rope",3,13.2788890780223
32.6295616197938,7,34.4357273865539,4,42.938893839327,10,1,"rope",3,10.3093322195332
13.3065535804085,8,17.3623142321574,5,29.2980577053639,4,1,"rope",4,15.9915041249554
13.5598327460837,8,17.3623142321574,5,34.375243808202,1,1,"rope",7,20.8154110621183
14.3059629334586,8,18.7743881966773,1,28.6303516435276,10,1,"rope",2,14.324388710069
4.72474902634084,9,10.4522557030047,5,32.5818774406711,2,1,"rope",7,27.8571284143303
6.37159966784725,9,10.4522557030047,5,25.0215939806542,5,1,"rope",4,18.6499943128069
21.6239153298083,9,38.082512050845,3,52.7501961178247,3,1,"rope",6,31.1262807880164
5.01766168794839,10,27.5554180821476,3,44.7466175867156,6,1,"rope",4,39.7289558987672
5.64304252282339,10,27.5554180821476,3,43.4733870853803,8,1,"rope",2,37.8303445625569
7.95914804365697,10,27.5554180821476,3,43.4733870853803,8,1,"rope",2,35.5142390417233
0.272599509241131,1,1,1,24.0820507009715,9,1,"rope",8,23.8094511917304
0.273680146107522,1,1,1,10.1226205124241,5,1,"rope",4,9.84894036631658
0.430894539383189,1,1,1,10.1226205124241,5,1,"rope",4,9.69172597304091
0.659904305514828,1,1,1,16.7179713866759,6,1,"rope",5,16.0580670811611
3.1775094498635,1,13.6693724474216,4,22.3124154249532,3,1,"rope",2,19.1349059750897
4.44294837436505,1,13.6693724474216,4,34.4707586444683,10,1,"rope",9,30.0278102701032
5.662921649761,1,13.6693724474216,4,22.3124154249532,3,1,"rope",2,16.6494937751922
6.07870091390209,1,13.6693724474216,4,32.3267921143043,7,1,"rope",6,26.2480912004022
7.40833787415045,1,13.6693724474216,4,32.3267921143043,7,1,"rope",6,24.9184542401538
9.36838868605753,1,13.6693724474216,4,32.3267921143043,7,1,"rope",6,22.9584034282468
0.217095423924635,2,1.36308829714225,1,20.3728361396551,8,1,"rope",6,20.1557407157305
0.339864975617479,2,1.36308829714225,1,16.7179713866759,6,1,"rope",4,16.3781064110584
0.749954416383581,2,1.36308829714225,1,20.3728361396551,8,1,"rope",6,19.6228817232715
0.809867968713033,2,1.36308829714225,1,20.3728361396551,8,1,"rope",6,19.5629681709421
1.40740853867038,2,8.26891682093598,2,12.761202695743,5,1,"rope",3,11.3537941570726
1.45028996088086,2,8.26891682093598,2,19.7293499105366,9,1,"rope",7,18.2790599496557
1.836922163074,2,8.26891682093598,2,13.9947643159524,6,1,"rope",4,12.1578421528784
2.63806089717638,2,8.26891682093598,2,29.4914988449961,10,1,"rope",8,26.8534379478197
5.67228604474779,2,8.26891682093598,2,12.409703025631,4,1,"rope",2,6.73741698088321
6.23608016496267,2,8.26891682093598,2,29.4914988449961,10,1,"rope",8,23.2554186800334
3.04466629011517,3,36.7910973287551,5,54.5369842277236,7,1,"rope",4,51.4923179376084
3.57329374209007,3,36.7910973287551,5,61.4332897199787,10,1,"rope",7,57.8599959778886
5.10861913322411,3,23.5626582551538,5,25.2235979244021,1,1,"rope",2,20.114978791178
7.39901656293686,3,36.7910973287551,5,54.5369842277236,7,1,"rope",4,47.1379676647867
7.62310528577681,3,36.7910973287551,5,59.6517869614296,9,1,"rope",6,52.0286816756528
8.29310602377545,3,36.7910973287551,5,46.8160588205816,5,1,"rope",2,38.5229527968062
8.32868635882775,3,36.7910973287551,5,46.8160588205816,5,1,"rope",2,38.4873724617538
8.61174565615695,3,36.7910973287551,5,46.8160588205816,5,1,"rope",2,38.2043131644247
11.517664489957,3,36.7910973287551,5,47.9156005784686,6,1,"rope",3,36.3979360885116
11.5766869321026,3,36.7910973287551,5,58.3323077930198,8,1,"rope",5,46.7556208609172
1.56902121690412,4,25.3946308090517,4,32.3267921143043,7,1,"rope",3,30.7577708974002
7.76054325179822,4,25.3946308090517,4,32.3267921143043,7,1,"rope",3,24.5662488625061
8.76792978782521,4,25.3946308090517,4,34.0212225142169,9,1,"rope",5,25.2532927263917
3.41885806668206,5,25.9402099984895,4,33.7365984233523,8,1,"rope",3,30.3177403566702
4.93292769403164,5,25.9402099984895,4,34.4707586444683,10,1,"rope",5,29.5378309504367
7.66110934058045,5,25.9402099984895,4,32.3267921143043,7,1,"rope",2,24.6656827737238
0.791958911015514,6,2.14912638068199,3,10.7620903861813,10,1,"rope",4,9.97013147516579
6.19671301895802,6,14.6775608578052,5,23.5626582551538,3,1,"rope",3,17.3659452361958
13.2208574805373,6,46.0999436011094,3,58.1627909036382,10,1,"rope",4,44.9419334231009
0.494751797205028,7,9.7570950352899,5,18.5705059876788,5,1,"rope",2,18.0757541904738
0.672778661510167,7,5.97361201194741,3,10.7620903861813,10,1,"rope",3,10.0893117246711
10.6014591951142,7,14.2343972582238,2,19.7293499105366,9,1,"rope",2,9.1278907154224
0.120555673105021,8,6.96219984987314,5,23.5626582551538,3,1,"rope",5,23.4421025820488
6.14954870321411,8,25.8994603112151,3,30.5170518374597,4,1,"rope",4,24.3675031342456
6.86861454240244,8,25.8994603112151,3,39.0586863608812,1,1,"rope",7,32.1900718184788
0.17977986484766,9,3.07258136569544,5,23.5626582551538,3,1,"rope",6,23.3828783903061
4.46067998482192,9,17.5186527502544,3,27.293470806758,7,1,"rope",2,22.8327908219361
5.23334712396963,9,17.5186527502544,3,27.293470806758,7,1,"rope",2,22.0601236827884
0.762836113572121,10,1,5,25.2235979244021,1,1,"rope",9,24.46076181083
13.4964306086751,10,16.7781443299081,3,27.293470806758,7,1,"rope",3,13.7970401980829
18.0728261692119,10,34.5844981443758,2,49.6344660815662,2,1,"rope",8,31.5616399123543
1.18294740334208,1,9.4536543736471,2,29.2900387258544,10,1,"rope",9,28.1070913225123
1.37997126284594,1,9.4536543736471,2,22.2202683520954,7,1,"rope",6,20.8402970892495
2.09290688931074,1,9.4536543736471,2,19.0022247159433,6,1,"rope",5,16.9093178266326
2.15360852870222,1,9.4536543736471,2,26.2088663223354,9,1,"rope",8,24.0552577936332
2.58612055824201,1,9.4536543736471,2,15.1854209250491,4,1,"rope",3,12.5993003668071
3.32766800216664,1,9.4536543736471,2,19.0022247159433,6,1,"rope",5,15.6745567137767
6.0147723259195,1,9.4536543736471,2,23.7260409309978,8,1,"rope",7,17.7112686050783
8.42754065435585,1,9.4536543736471,2,12.9590817544187,3,1,"rope",2,4.53154110006285
9.59153970516948,1,16.1057241043171,5,41.9278555841089,10,1,"rope",9,32.3363158789394
10.6248011509254,1,16.1057241043171,5,40.6822154886692,9,1,"rope",8,30.0574143377438
0.932573629501176,2,1.17896590345925,1,14.4551316352005,8,1,"rope",6,13.5225580056993
2.33143701950524,2,19.3749033450889,5,41.9278555841089,10,1,"rope",8,39.5964185646037
2.43480412709945,2,19.3749033450889,5,39.3468515027684,8,1,"rope",6,36.912047375669
2.54791040766471,2,19.3749033450889,5,41.9278555841089,10,1,"rope",8,39.3799451764442
3.62519815887267,2,19.3749033450889,5,41.9278555841089,10,1,"rope",8,38.3026574252362
4.23502328150848,2,19.3749033450889,5,35.046037028856,6,1,"rope",4,30.8110137473475
5.1899966932128,2,19.3749033450889,5,35.046037028856,6,1,"rope",4,29.8560403356432
7.84360706972792,2,19.3749033450889,5,35.046037028856,6,1,"rope",4,27.2024299591281
9.02510727545605,2,19.3749033450889,5,34.3145200170196,5,1,"rope",3,25.2894127415636
9.05737994028614,2,19.3749033450889,5,25.9251427390939,4,1,"rope",2,16.8677627988078
0.293009498450536,3,3.91467405214852,1,17.1967136685717,10,1,"rope",7,16.9037041701212
0.784166084896404,3,3.91467405214852,1,11.7206709024444,6,1,"rope",3,10.936504817548
0.851793713991256,3,10.3331395867918,5,13.2586288970059,1,1,"rope",2,12.4068351830146
1.40504895861513,3,3.91467405214852,1,12.7159430173408,7,1,"rope",4,11.3108940587257
3.62520190840343,3,22.3108536632408,4,31.5541856249445,7,1,"rope",4,27.9289837165411
3.81177433160821,3,10.3331395867918,5,13.2586288970059,1,1,"rope",2,9.44685456539769
5.49720981103105,3,22.3108536632408,4,40.0157893942485,10,1,"rope",7,34.5185795832175
6.61725993115647,3,22.3108536632408,4,34.8897669926455,8,1,"rope",5,28.272507061489
6.65270064898027,3,22.3108536632408,4,31.5541856249445,7,1,"rope",4,24.9014849759642
8.12916421278151,3,22.3108536632408,4,38.4269389375494,9,1,"rope",6,30.2977747247679
2.649483512947,4,7.07594810291255,1,16.6248314774918,9,1,"rope",5,13.9753479645448
5.5576007934591,4,7.07594810291255,1,12.7159430173408,7,1,"rope",3,7.1583422238817
5.75957204808104,4,7.07594810291255,1,12.7159430173408,7,1,"rope",3,6.95637096925976
0.615182948430763,5,1,3,8.98585363791081,7,1,"rope",2,8.37067068948005
0.834966872482625,5,1,4,8.00804190270642,3,1,"rope",2,7.17307503022379
1.25983464127193,5,6.95839867520042,5,10.3331395867918,3,1,"rope",2,9.07330494551987
0.84352700971067,6,1.29966104437454,3,11.2639981203752,8,1,"rope",2,10.4204711106645
2.75933962780982,6,5.21557855969836,5,7.36249658804462,4,1,"rope",2,4.6031569602348
3.63248077686876,6,5.21557855969836,5,11.9168368687479,2,1,"rope",4,8.28435609187914
1.2451483034293,7,8.98585363791081,3,14.0037891900819,10,1,"rope",3,12.7586408866526
3.88548778710669,7,22.1147891351324,1,25.076001365417,5,1,"rope",2,21.1905135783103
10.3883675020408,7,22.1147891351324,1,37.0044763171472,2,1,"rope",5,26.6161088151064
5.48611389207223,8,34.5079385286215,2,48.8787241006551,5,1,"rope",3,43.3926102085829
7.84228848814918,8,34.5079385286215,2,58.7696820901259,1,1,"rope",7,50.9273936019767
9.96463603395922,8,34.5079385286215,2,48.8787241006551,5,1,"rope",3,38.9140880666959
1.59996387162141,9,26.3525563251489,3,31.6668151426279,5,1,"rope",4,30.0668512710065
2.35309320551645,9,26.3525563251489,3,41.1412092562272,1,1,"rope",8,38.7881160507107
2.37831477125477,9,26.3525563251489,3,37.2632990088407,2,1,"rope",7,34.8849842375859
0.45663519607236,10,1,5,10.3331395867918,3,1,"rope",7,9.87650439071944
1.87850315279017,10,18.6966664145604,3,31.6668151426279,5,1,"rope",5,29.7883119898377
3.52200759574771,10,18.6966664145604,3,37.0192640338769,4,1,"rope",6,33.4972564381292
1.06339151035519,1,6.70860076281705,2,18.2094915513388,3,1,"rope",2,17.1461000409836
1.40980766243757,1,6.70860076281705,2,26.5728538732385,6,1,"rope",5,25.1630462108009
4.71080120166248,1,6.70860076281705,2,30.6771003027038,7,1,"rope",6,25.9662991010413
6.83998619382926,1,11.890641063838,4,18.5736696382929,5,1,"rope",4,11.7336834444636
7.8524191620312,1,11.890641063838,4,19.2404973697878,7,1,"rope",6,11.3880782077566
9.23339625988792,1,11.890641063838,4,18.5736696382929,5,1,"rope",4,9.34027337840498
9.48102112309151,1,11.890641063838,4,20.6780813786842,9,1,"rope",8,11.1970602555927
9.70432985349633,1,11.890641063838,4,18.5736696382929,5,1,"rope",4,8.86933978479657
10.3161698175509,1,11.890641063838,4,19.2404973697878,7,1,"rope",6,8.9243275522369
10.3226384847807,1,11.890641063838,4,18.5736696382929,5,1,"rope",4,8.2510311535122
0.974015208850515,2,2.86751843049171,1,20.1181525603623,8,1,"rope",6,19.1441373515118
3.04009411564533,2,12.5602308813745,2,31.5158639814931,8,1,"rope",6,28.4757698658478
3.07989626970578,2,12.5602308813745,2,31.5158639814931,8,1,"rope",6,28.4359677117873
3.38465848971594,2,12.5602308813745,2,35.1119653996488,10,1,"rope",8,31.7273069099329
5.03284563149741,2,12.5602308813745,2,35.1119653996488,10,1,"rope",8,30.0791197681514
5.86193948925959,2,12.5602308813745,2,26.2971548709428,5,1,"rope",3,20.4352153816832
6.86903837447065,2,12.5602308813745,2,26.2971548709428,5,1,"rope",3,19.4281164964721
10.0401041443922,2,12.5602308813745,2,30.6771003027038,7,1,"rope",5,20.6369961583116
11.7320526103112,2,12.5602308813745,2,30.6771003027038,7,1,"rope",5,18.9450476923926
13.1432610088673,2,30.1265657200715,5,36.9161843819382,4,1,"rope",2,23.7729233730709
0.15423442190513,3,3.50823446094039,1,17.3516498921794,6,1,"rope",3,17.1974154702743
0.446069592610002,3,3.50823446094039,1,20.7319319626537,9,1,"rope",6,20.2858623700437
0.745194298680872,3,3.50823446094039,1,20.7319319626537,9,1,"rope",6,19.9867376639728
1.10934954146066,3,3.50823446094039,1,20.1181525603623,8,1,"rope",5,19.0088030189016
2.47749867202381,3,3.50823446094039,1,20.1181525603623,8,1,"rope",5,17.6406538883385
3.87742453903538,3,33.7441069386346,5,41.3017420517709,7,1,"rope",4,37.4243175127355
3.93195748838525,3,33.7441069386346,5,40.6523411374355,6,1,"rope",3,36.7203836490502
4.09458791228872,3,33.7441069386346,5,44.3214948413806,8,1,"rope",5,40.2269069290919
4.62285391890373,3,33.7441069386346,5,48.8677277566155,10,1,"rope",7,44.2448738377118
6.58892906725316,3,33.7441069386346,5,46.5505911803087,9,1,"rope",6,39.9616621130555
0.150340055247621,4,3.99741123911885,4,5.78995503385057,2,1,"rope",2,5.63961497860295
0.682587383136626,4,51.6666484766399,4,74.6787867654008,9,1,"rope",5,73.9961993822642
0.907605985410064,4,3.99741123911885,4,5.78995503385057,2,1,"rope",2,4.88234904844051
0.732478848658502,5,1,4,9.381717242528,1,1,"rope",4,8.6492383938695
1.75860271323472,5,51.917962638544,4,78.3388152461575,10,1,"rope",5,76.5802125329228
7.57790644780356,5,51.917962638544,4,74.6787867654008,9,1,"rope",4,67.1008803175972
4.54578701082273,6,28.3846585337593,3,44.5706328967545,1,1,"rope",5,40.0248458859318
7.66490691623894,6,28.3846585337593,3,44.5706328967545,1,1,"rope",5,36.9057259805156
8.36989765958794,6,63.257276496357,4,71.9343173632962,8,1,"rope",2,63.5644197037083
2.00381102195631,7,26.2498857189021,3,37.4490102923142,3,1,"rope",4,35.4451992703579
2.46712596931805,7,26.2498857189021,3,44.5706328967545,1,1,"rope",6,42.1035069274365
3.48439941271181,7,26.2498857189021,3,44.5706328967545,1,1,"rope",6,41.0862334840427
3.91938103286837,8,8.49267197403977,5,21.9149535864424,3,1,"rope",5,17.995572553574
4.27481644089932,8,8.49267197403977,5,23.0070335969594,1,1,"rope",7,18.7322171560601
6.35041576113219,8,8.49267197403977,5,14.8354684083573,6,1,"rope",2,8.48505264722511
1.62148547358811,9,6.17726202656455,5,23.0070335969594,1,1,"rope",8,21.3855481233713
2.31231871983782,9,6.17726202656455,5,14.8354684083573,6,1,"rope",3,12.5231496885195
4.57580080402519,9,6.17726202656455,5,20.1051997299423,4,1,"rope",5,15.5293989259171
2.61323497848214,10,19.8369395545937,3,26.2498857189021,7,1,"rope",3,23.63665074042
3.30023089020452,10,19.8369395545937,3,26.2498857189021,7,1,"rope",3,22.9496548286976
15.1341626648203,10,19.8369395545937,3,28.3846585337593,6,1,"rope",4,13.250495868939
2.66949248860095,1,12.6805960532183,2,30.9710709745565,8,1,"rope",7,28.3015784859556
3.710801990052,1,12.6805960532183,2,29.7389452432548,7,1,"rope",6,26.0281432532028
4.16011638409135,1,12.6805960532183,2,39.0039214770191,10,1,"rope",9,34.8438050929277
7.1633870621455,1,12.6805960532183,2,27.5013909942511,6,1,"rope",5,20.3380039321056
7.8890065160403,1,12.6805960532183,2,39.0039214770191,10,1,"rope",9,31.1149149609788
8.19880774950702,1,12.6805960532183,2,30.9710709745565,8,1,"rope",7,22.7722632250495
8.33526774782781,1,12.6805960532183,2,22.5434637913415,5,1,"rope",4,14.2081960435137
8.76260140918288,1,12.6805960532183,2,39.0039214770191,10,1,"rope",9,30.2413200678362
9.46533758382862,1,12.6805960532183,2,22.5434637913415,5,1,"rope",4,13.0781262075129
9.66607071788599,1,12.6805960532183,2,30.9710709745565,8,1,"rope",7,21.3050002566705
1.45308650232831,2,3.22710722490194,1,6.73551747520582,4,1,"rope",2,5.28243097287751
2.96883599399549,2,3.22710722490194,1,6.73551747520582,4,1,"rope",2,3.76668148121033
3.34744914793369,2,22.6660641634004,4,38.6110025043347,8,1,"rope",6,35.263553356401
3.9034799312703,2,22.6660641634004,4,35.2556577818944,5,1,"rope",3,31.3521778506241
4.93734352671693,2,22.6660641634004,4,42.8355163514231,10,1,"rope",8,37.8981728247062
7.15611062353069,2,22.6660641634004,4,42.8355163514231,10,1,"rope",8,35.6794057278924
8.05639120134181,2,22.6660641634004,4,37.2630708676743,7,1,"rope",5,29.2066796663325
12.1789078686021,2,22.6660641634004,4,38.6110025043347,8,1,"rope",6,26.4320946357326
12.4096903788492,2,22.6660641634004,4,31.8734026064992,4,1,"rope",2,19.46371222765
13.8075328064808,2,22.6660641634004,4,35.2556577818944,5,1,"rope",3,21.4481249754136
0.531016607426147,3,3.12704407170703,4,13.7277894176178,1,1,"rope",2,13.1967728101917
5.16528371755164,3,32.2278455708078,1,38.1266534002544,1,1,"rope",2,32.9613696827028
5.44906662376444,3,33.8334406988622,5,41.2158515251776,8,1,"rope",5,35.7667849014132
5.9362309074014,3,32.2278455708078,1,38.1266534002544,1,1,"rope",2,32.190422492853
6.78535632185732,3,32.2278455708078,1,38.1266534002544,1,1,"rope",2,31.3412970783971
7.52603749882048,3,33.8334406988622,5,35.7476149738292,5,1,"rope",2,28.2215774750087
7.69769230762115,3,33.8334406988622,5,37.85281209117,6,1,"rope",3,30.1551197835489
7.70003243533512,3,33.8334406988622,5,37.85281209117,6,1,"rope",3,30.1527796558349
8.50883732862993,3,32.2278455708078,1,38.1266534002544,1,1,"rope",2,29.6178160716245
8.91369654031485,3,33.8334406988622,5,46.4909595605554,10,1,"rope",7,37.5772630202406
7.64135877952626,4,18.9156558928566,5,21.7773891695887,2,1,"rope",2,14.1360303900624
12.0257551784471,4,18.9156558928566,5,21.7773891695887,2,1,"rope",2,9.7516339911416
14.5478963136679,4,18.9156558928566,5,21.7773891695887,2,1,"rope",2,7.2294928559208
0.78705421693839,5,1,3,4.43764378629689,8,1,"rope",3,3.6505895693585
9.38407892722941,5,48.4050114009213,1,57.0833687633616,10,1,"rope",5,47.6992898361322
9.86270494344639,5,48.4050114009213,1,56.9012347360714,9,1,"rope",4,47.038529792625
2.10764344626417,6,9.10246246892603,1,13.0402303603563,10,1,"rope",4,10.9325869140921
7.58310179097557,6,9.10246246892603,1,13.0402303603563,10,1,"rope",4,5.45712856938073
10.8146936897835,6,25.180357441712,1,36.6070975745647,2,1,"rope",4,25.7924038847812
0.189302828996413,7,13.0563281263746,5,21.7773891695887,2,1,"rope",5,21.5880863405923
9.36257106355444,7,13.0563281263746,5,17.2110569185512,5,1,"rope",2,7.84848585499676
9.76204252284383,7,13.0563281263746,5,24.3248026241225,1,1,"rope",6,14.5627601012787
1.61516910263648,8,9.39053129958469,5,15.239807236505,6,1,"rope",2,13.6246381338685
5.15011952399864,8,9.39053129958469,5,17.2110569185512,5,1,"rope",3,12.0609373945526
6.19519171446218,8,9.39053129958469,5,21.7773891695887,2,1,"rope",6,15.5821974551265
3.35725401514477,9,21.7361001055125,1,27.6088885102276,5,1,"rope",4,24.2516344950828
8.02909657627855,9,21.7361001055125,1,28.0361372337042,4,1,"rope",5,20.0070406574256
8.10247194445893,9,21.7361001055125,1,36.6070975745647,2,1,"rope",7,28.5046256301058
0.912721207826259,10,1,5,9.39053129958469,8,1,"rope",2,8.47781009175843
3.11859694417707,10,17.1119968624628,1,32.2278455708078,3,1,"rope",7,29.1092486266307
8.33170410523763,10,17.1119968624628,1,23.1432132975567,7,1,"rope",3,14.8115091923191
5.41244833328226,1,23.6940519893359,5,46.7165327358476,10,1,"rope",9,41.3040844025653
5.41604354659774,1,23.6940519893359,5,32.3817679845532,4,1,"rope",3,26.9657244379555
5.84654945562341,1,23.6940519893359,5,33.1917238400013,5,1,"rope",4,27.3451743843779
5.86090642315083,1,23.6940519893359,5,46.7165327358476,10,1,"rope",9,40.8556263126968
5.96648770387444,1,23.6940519893359,5,36.9654790883996,6,1,"rope",5,30.9989913845252
6.33718974844712,1,23.6940519893359,5,46.7165327358476,10,1,"rope",9,40.3793429874005
9.15528230830625,1,23.6940519893359,5,32.3817679845532,4,1,"rope",3,23.226485676247
9.66747987266228,1,23.6940519893359,5,45.741775862706,9,1,"rope",8,36.0742959900437
9.97825445789441,1,23.6940519893359,5,29.0142649025566,3,1,"rope",2,19.0360104446622
11.1486700222926,1,23.6940519893359,5,45.741775862706,9,1,"rope",8,34.5931058404134
0.652235292384537,2,1.18649439676352,1,31.2502745100234,10,1,"rope",8,30.5980392176389
1.51912196304373,2,7.00002301411704,2,25.8302862262185,8,1,"rope",6,24.3111642631748
1.78646187156163,2,7.00002301411704,2,29.0596954624647,10,1,"rope",8,27.2732335909031
4.43016554260786,2,7.00002301411704,2,18.0063767284191,5,1,"rope",3,13.5762111858112
5.27348476955351,2,7.00002301411704,2,24.5069750025044,6,1,"rope",4,19.2334902329509
5.331927105595,2,7.00002301411704,2,16.9636277860764,4,1,"rope",2,11.6317006804814
7.23051069649532,2,28.857430116477,4,47.1145495986333,10,1,"rope",8,39.884038902138
8.23424566691861,2,28.857430116477,4,47.1145495986333,10,1,"rope",8,38.8803039317147
9.27911876385676,2,28.857430116477,4,33.3511329868694,4,1,"rope",2,24.0720142230126
9.36626739323349,2,28.857430116477,4,34.5091386967823,5,1,"rope",3,25.1428713035488
0.82451858274163,3,4.67147829189672,1,27.4282267508083,8,1,"rope",5,26.6037081680667
1.00461215475099,3,4.67147829189672,1,11.7088677056288,5,1,"rope",2,10.7042555508778
1.38986377793625,3,4.67147829189672,1,21.5546824837068,7,1,"rope",4,20.1648187057705
1.55886375208646,3,4.67147829189672,1,17.3597875155893,6,1,"rope",3,15.8009237635028
3.17725101123488,3,4.67147829189672,1,11.7088677056288,5,1,"rope",2,8.53161669439392
3.47868028339854,3,4.67147829189672,1,31.2502745100234,10,1,"rope",7,27.7715942266249
3.95204181280843,3,4.67147829189672,1,21.5546824837068,7,1,"rope",4,17.6026406708984
6.64668382562126,3,30.2111458603466,4,34.5091386967823,5,1,"rope",2,27.862454871161
6.85329613645921,3,9.77104907068324,4,12.7314769973817,1,1,"rope",2,5.87818086092249
9.10990935363515,3,30.2111458603466,4,46.6013713562861,9,1,"rope",6,37.4914620026509
9.00069870633594,4,60.7462081601468,3,69.5396388717482,9,1,"rope",5,60.5389401654123
12.5032876333209,4,60.7462081601468,3,63.8901551570572,6,1,"rope",2,51.3868675237363
15.7597365254364,4,60.7462081601468,3,65.627033630532,7,1,"rope",3,49.8672971050956
0.325429692553977,5,1,3,17.1350038778162,7,1,"rope",2,16.8095741852622
2.89979512944474,5,7.59390134366189,5,17.2600492639238,2,1,"rope",3,14.3602541344791
7.58835004445376,5,18.0063767284191,2,28.5869725219513,9,1,"rope",4,20.9986224774975
0.81114331415544,6,7.03746704723429,3,19.5613984922491,9,1,"rope",3,18.7502551780937
2.91905390719573,6,7.03746704723429,3,21.4278341011623,10,1,"rope",4,18.5087801939666
5.00476844608784,6,7.03746704723429,3,19.5613984922491,9,1,"rope",3,14.5566300461613
4.72227388344018,7,39.4510761011602,1,42.9516112144323,5,1,"rope",2,38.2293373309921
7.3697433119785,7,39.4510761011602,1,45.6782320588311,2,1,"rope",5,38.3084887468526
7.56264597135496,7,39.4510761011602,1,46.9617668015639,1,1,"rope",6,39.3991208302089
3.27506838706609,8,40.0247111582314,2,49.2682593070305,1,1,"rope",7,45.9931909199644
3.72464485153302,8,18.6039567803858,3,21.4278341011623,10,1,"rope",2,17.7031892496293
8.82820779737386,8,40.0247111582314,2,49.2682593070305,1,1,"rope",7,40.4400515096566
2.3679643961132,9,35.1771189934757,3,38.5066480394261,7,1,"rope",2,36.1386836433129
5.17790866056391,9,35.1771189934757,3,46.172571890049,2,1,"rope",7,40.9946632294851
16.9720235545065,9,35.1771189934757,3,40.4942741292875,4,1,"rope",5,23.522250574781
0.570074231490302,10,1,5,17.2600492639238,2,1,"rope",8,16.6899750324335
5.07705162743613,10,29.6892680045537,3,46.172571890049,2,1,"rope",8,41.0955202626129
8.45242578055252,10,29.6892680045537,3,40.7466982152763,3,1,"rope",7,32.2942724347238
0.833716561975789,1,1,1,26.2243159039787,9,1,"rope",8,25.3905993420029
0.894966236275381,1,1,1,6.05687749965681,3,1,"rope",2,5.16191126338143
5.83122185677382,1,6.44810428535574,2,12.7470819374156,4,1,"rope",3,6.91586008064178
6.73636888950936,1,15.1949299281722,4,27.686932848847,5,1,"rope",4,20.9505639593376
11.2210074200183,1,15.1949299281722,4,27.686932848847,5,1,"rope",4,16.4659254288287
11.4465877682144,1,15.1949299281722,4,30.8982290227968,9,1,"rope",8,19.4516412545824
13.2439905393966,1,15.1949299281722,4,25.2899975065257,4,1,"rope",3,12.0460069671291
13.2824543261066,1,15.1949299281722,4,30.8982290227968,9,1,"rope",8,17.6157746966902
14.0637476657062,1,15.1949299281722,4,30.8982290227968,9,1,"rope",8,16.8344813570906
14.4942228098876,1,15.1949299281722,4,20.8942674493434,3,1,"rope",2,6.4000446394558
0.0232994565740228,2,3.74371017324118,1,25.051785652307,8,1,"rope",6,25.028486195733
0.367669525090605,2,3.74371017324118,1,15.0994386241747,6,1,"rope",4,14.7317690990841
0.915095323696733,2,3.74371017324118,1,12.0541164111927,5,1,"rope",3,11.139021087496
2.90483652605655,2,3.74371017324118,1,15.0994386241747,6,1,"rope",4,12.1946020981181
3.72990316270897,2,8.07146317976669,2,14.2635970623573,5,1,"rope",3,10.5336938996483
6.26734411635918,2,8.07146317976669,2,14.2635970623573,5,1,"rope",3,7.99625294599812
6.88048749522788,2,8.07146317976669,2,15.2259644382042,6,1,"rope",4,8.34547694297632
7.76543033257192,2,8.07146317976669,2,12.7470819374156,4,1,"rope",2,4.98165160484368
11.1710907679612,2,35.9853690026277,5,52.7732649643851,9,1,"rope",7,41.6021741964239
13.6378148786025,2,35.9853690026277,5,48.1308308830156,7,1,"rope",5,34.4930160044131
0.175217626265107,3,5.9016113747407,4,9.36370000713418,1,1,"rope",2,9.18848238086907
0.380443276708124,3,38.3267115924306,5,50.4643369757669,8,1,"rope",5,50.0838936990588
3.28085735270697,3,5.9016113747407,4,9.36370000713418,1,1,"rope",2,6.08284265442721
6.09009463701673,3,38.3267115924306,5,46.0457796730999,6,1,"rope",3,39.9556850360832
6.41391676343389,3,38.3267115924306,5,46.0457796730999,6,1,"rope",3,39.631862909666
9.36667057451781,3,38.3267115924306,5,57.6688115507816,10,1,"rope",7,48.3021409762638
11.7634711240926,3,38.3267115924306,5,50.4643369757669,8,1,"rope",5,38.7008658516743
12.8320431795991,3,38.3267115924306,5,46.0457796730999,6,1,"rope",3,33.2137364935008
15.7638017471219,3,38.3267115924306,5,57.6688115507816,10,1,"rope",7,41.9050098036597
15.9988311465169,3,38.3267115924306,5,48.1308308830156,7,1,"rope",4,32.1319997364987
0.581561694853008,4,12.7470819374156,2,15.2259644382042,6,1,"rope",2,14.6444027433512
7.19914779815136,4,12.7470819374156,2,17.4272726580347,7,1,"rope",3,10.2281248598833
11.2842231901463,4,12.7470819374156,2,19.9237221095624,10,1,"rope",6,8.6394989194161
4.56137198009495,5,27.686932848847,4,35.4497565247218,10,1,"rope",5,30.8883845446268
5.12725003390473,5,27.28845991653,3,33.4684874476427,2,1,"rope",3,28.341237413738
7.36338830724569,5,27.686932848847,4,35.4497565247218,10,1,"rope",5,28.0863682174761
2.11756428548445,6,36.4425486052744,2,45.3243596101168,4,1,"rope",2,43.2067953246324
5.04179310815686,6,15.2259644382042,2,18.5354935310694,8,1,"rope",2,13.4937004229125
5.48103606003924,6,36.4425486052744,2,46.5929162439413,3,1,"rope",3,41.1118801839021
0.996460376427261,7,7.30877197819684,5,20.0946432108182,1,1,"rope",6,19.0981828343909
1.23309451343609,7,7.30877197819684,5,18.4859009290853,2,1,"rope",5,17.2528064156492
1.91185202793025,7,7.30877197819684,5,20.0946432108182,1,1,"rope",6,18.182791182888
8.6473337494603,8,18.5354935310694,2,19.9237221095624,10,1,"rope",2,11.2763883601021
12.1815584269103,8,21.7485450533426,3,34.8203937521001,1,1,"rope",7,22.6388353251898
13.3003780815191,8,21.7485450533426,3,27.7688469785506,4,1,"rope",4,14.4684688970315
10.1700017278442,9,15.5257434760994,3,26.4729661372964,6,1,"rope",3,16.3029644094522
13.7888147343417,9,15.5257434760994,3,32.0621361094089,3,1,"rope",6,18.2733213750672
18.0698052733203,9,29.6150628030828,2,47.6933539303496,1,1,"rope",8,29.6235486570293
0.188027736181851,10,1,5,18.4859009290853,2,1,"rope",8,18.2978731929034
0.627288304030732,10,1,5,11.7287454161044,5,1,"rope",5,11.1014571120737
4.94732916751889,10,10.3511500352754,3,32.0621361094089,3,1,"rope",7,27.11480694189
1.57883597529473,1,7.03326888170965,2,11.0707664609919,4,1,"rope",3,9.49193048569717
4.93328357203372,1,7.03326888170965,2,15.49949079734,7,1,"rope",6,10.5662072253063
4.94319859667644,1,7.03326888170965,2,16.7739992945521,8,1,"rope",7,11.8308006978757
5.23114412100017,1,7.03326888170965,2,17.6585659007335,9,1,"rope",8,12.4274217797333
5.69915798081979,1,7.03326888170965,2,15.2577277285234,6,1,"rope",5,9.55856974770361
6.1408419349134,1,7.03326888170965,2,18.1696555048952,10,1,"rope",9,12.0288135699818
6.99537469450803,1,7.03326888170965,2,18.1696555048952,10,1,"rope",9,11.1742808103872
8.43135814736996,1,15.3887277682121,4,19.0305028607415,3,1,"rope",2,10.5991447133715
9.4678557206962,1,15.3887277682121,4,30.855738561238,7,1,"rope",6,21.3878828405418
12.4817487819708,1,15.3887277682121,4,19.0305028607415,3,1,"rope",2,6.5487540787707
0.542860847432166,2,1.6210965923965,1,7.30107246170582,4,1,"rope",2,6.75821161427365
0.925094637088478,2,1.6210965923965,1,16.1707767224246,10,1,"rope",8,15.2456820853361
0.970829335952687,2,1.6210965923965,1,16.1707767224246,10,1,"rope",8,15.1999473864719
1.44652175621926,2,7.51152938043639,2,13.1198001098682,5,1,"rope",3,11.6732783536489
2.0068931267397,2,7.51152938043639,2,16.7739992945521,8,1,"rope",6,14.7671061678124
3.61935822515593,2,7.51152938043639,2,16.7739992945521,8,1,"rope",6,13.1546410693962
3.87946000755529,2,7.51152938043639,2,15.2577277285234,6,1,"rope",4,11.3782677209681
4.17474997802402,2,7.51152938043639,2,13.1198001098682,5,1,"rope",3,8.94505013184418
4.75471483277852,2,7.51152938043639,2,13.1198001098682,5,1,"rope",3,8.36508527708968
5.84944733281842,2,7.51152938043639,2,17.6585659007335,9,1,"rope",7,11.8091185679151
0.116478958638015,3,6.4184630426795,4,9.37857435657652,1,1,"rope",2,9.26209539793851
2.08773841095659,3,6.4184630426795,4,9.37857435657652,1,1,"rope",2,7.29083594561993
3.08532082137678,3,5.86369753450812,1,11.4599560433815,8,1,"rope",5,8.37463522200472
4.50266090883957,3,5.86369753450812,1,11.4599560433815,8,1,"rope",5,6.95729513454193
5.14895137968557,3,6.4184630426795,4,9.37857435657652,1,1,"rope",2,4.22962297689095
5.97482902655917,3,6.4184630426795,4,9.37857435657652,1,1,"rope",2,3.40374533001735
6.29457639582994,3,19.0305028607415,4,34.0173560641225,10,1,"rope",7,27.7227796682926
6.48043203732538,3,19.0305028607415,4,22.0835042547545,5,1,"rope",2,15.6030722174291
6.81301172316614,3,19.0305028607415,4,32.6192201918162,9,1,"rope",6,25.8062084686501
6.84625255327999,3,19.0305028607415,4,32.3331691916111,8,1,"rope",5,25.4869166383311
5.6926278477786,4,50.7933944282985,5,74.1330222115202,10,1,"rope",6,68.4403943637416
8.10374268948246,4,50.7933944282985,5,67.5327352233674,7,1,"rope",3,59.4289925338849
8.12691722062943,4,50.7933944282985,5,72.8432507478049,9,1,"rope",5,64.7163335271755
0.351555485588809,5,1,4,6.4184630426795,3,1,"rope",2,6.06690755709069
2.30989303439856,5,16.4793684472751,5,20.4175422531918,3,1,"rope",2,18.1076492187932
20.6027553655339,5,32.5314732505963,1,36.7835633975817,3,1,"rope",2,16.1808080320478
0.947590403569241,6,5.68997548867889,3,10.5404233620916,8,1,"rope",2,9.59283295852236
1.51630213794609,6,5.68997548867889,3,14.3484486524146,10,1,"rope",4,12.8321465144685
11.7423849392048,6,14.8627638253339,5,26.369253307353,1,1,"rope",5,14.6268683681482
1.71647812550267,7,7.09049010275514,5,25.9320999734511,2,1,"rope",5,24.2156218479484
3.26125829635809,7,7.09049010275514,5,17.4642756713044,4,1,"rope",3,14.2030173749463
13.094943976423,7,30.6057886564767,3,41.6381305650179,1,1,"rope",6,28.5431865885949
0.214983405651803,8,10.5404233620916,3,14.3484486524146,10,1,"rope",2,14.1334652467628
10.6764245842082,8,11.4599560433815,1,16.1707767224246,10,1,"rope",2,5.4943521382164
17.0110082749391,8,26.9429666041504,1,31.7894422370494,6,1,"rope",2,14.7784339621103
0.9595432303225,9,1.57585883513093,5,26.369253307353,1,1,"rope",8,25.4097100770305
3.40240265248419,9,19.7662810035741,3,33.4008753910183,5,1,"rope",4,29.9984727385341
5.37731582459759,9,19.7662810035741,3,33.4008753910183,5,1,"rope",4,28.0235595664207
2.64647408995434,10,18.2244238858333,3,39.122394611064,2,1,"rope",8,36.4759205211097
3.14169322126512,10,18.2244238858333,3,41.6381305650179,1,1,"rope",9,38.4964373437528
4.41078976248358,10,18.2244238858333,3,27.4576157574409,8,1,"rope",2,23.0468259949573
0.123832949902862,1,1,1,7.68839904481181,6,1,"rope",5,7.56456609490895
0.746200105641037,1,1,1,17.709628411591,9,1,"rope",8,16.96342830595
0.850854525342584,1,1,1,10.7196365144579,7,1,"rope",6,9.86878198911532
1.28201221395284,1,2.55783346761018,2,10.0407768865387,6,1,"rope",5,8.75876467258586
2.97888600910994,1,11.8167685195406,4,19.9797660395291,6,1,"rope",5,17.0008800304192
3.51783381673487,1,11.8167685195406,4,23.9581936268585,9,1,"rope",8,20.4403598101236
3.93715915820541,1,11.8167685195406,4,14.6783429805257,4,1,"rope",3,10.7411838223203
5.26960460177127,1,11.8167685195406,4,17.2655336175273,5,1,"rope",4,11.995929015756
6.84044546035634,1,11.8167685195406,4,24.0282880402921,10,1,"rope",9,17.1878425799358
10.0065789980768,1,11.8167685195406,4,17.2655336175273,5,1,"rope",4,7.2589546194505
0.630679969210178,2,2.12734230132774,1,6.38811447288925,5,1,"rope",3,5.75743450367907
2.29093996101039,2,4.2607837286755,2,6.07405324404419,4,1,"rope",2,3.7831132830338
2.79144610269907,2,4.2607837286755,2,13.9269042091218,8,1,"rope",6,11.1354581064227
3.27196570663693,2,4.2607837286755,2,10.0407768865387,6,1,"rope",4,6.76881117990177
5.47437024468041,2,21.0262171214548,5,30.9346627551695,5,1,"rope",3,25.4602925104891
6.95855012134113,2,21.0262171214548,5,30.9346627551695,5,1,"rope",3,23.9761126338284
7.41042649595221,2,21.0262171214548,5,35.5819128809786,7,1,"rope",5,28.1714863850264
7.69867523795148,2,21.0262171214548,5,30.9346627551695,5,1,"rope",3,23.235987517218
9.19149094288372,2,21.0262171214548,5,35.5819128809786,7,1,"rope",5,26.3904219380949
14.2500785402727,2,21.0262171214548,5,29.5508670722219,4,1,"rope",2,15.3007885319492
0.873051603282702,3,5.83782979684002,1,17.709628411591,9,1,"rope",6,16.8365768083083
5.31517440889427,3,6.26761618654204,4,9.24808873555073,1,1,"rope",2,3.93291432665646
6.29525711167524,3,21.5720003233714,5,30.9346627551695,5,1,"rope",2,24.6394056434943
11.2323761929407,3,21.5720003233714,5,39.4387332755712,10,1,"rope",7,28.2063570826305
11.3596283021928,3,21.5720003233714,5,35.1590844297596,6,1,"rope",3,23.7994561275668
12.1482187508002,3,22.5424237315121,3,26.1101919766822,1,1,"rope",2,13.961973225882
13.31486865719,3,21.5720003233714,5,35.1590844297596,6,1,"rope",3,21.8442157725696
13.4713408498016,3,21.5720003233714,5,35.1590844297596,6,1,"rope",3,21.687743579958
14.6222173187384,3,21.5720003233714,5,35.1590844297596,6,1,"rope",3,20.5368671110212
15.291570862881,3,21.5720003233714,5,37.823989629539,9,1,"rope",6,22.532418766658
0.169939619178573,4,3.44929138748887,4,9.24808873555073,1,1,"rope",3,9.07814911637216
0.734329054442545,4,6.07405324404419,2,13.9269042091218,8,1,"rope",4,13.1925751546793
3.80079180453871,4,6.07405324404419,2,16.4645034400984,10,1,"rope",6,12.6637116355597
1.16316442171764,5,17.2655336175273,4,23.9581936268585,9,1,"rope",4,22.7950292051409
2.86663190410815,5,17.2655336175273,4,20.5960553049598,7,1,"rope",2,17.7294234008517
3.48485022887619,5,17.2655336175273,4,20.5960553049598,7,1,"rope",2,17.1112050760836
2.40487941837215,6,4.21235236253898,3,6.86053186372126,8,1,"rope",2,4.45565244534911
7.81296720065387,6,10.0407768865387,2,14.9861958032248,9,1,"rope",3,7.17322860257093
14.1717870029759,6,47.8365990684808,3,51.188716705074,8,1,"rope",2,37.0169297020981
0.473566681396102,7,3.14831698203313,5,9.87935826727364,4,1,"rope",3,9.40579158587754
4.04128770582876,7,33.1791360424775,2,46.5315576542995,2,1,"rope",5,42.4902699484707
4.31828617300934,7,33.1791360424775,2,41.2240082480819,4,1,"rope",3,36.9057220750726
2.88313909109338,8,15.3254979306195,3,24.4842938945844,2,1,"rope",6,21.601154803491
6.14180600946818,8,15.3254979306195,3,17.7464692497172,5,1,"rope",3,11.604663240249
13.2193268837955,8,15.3254979306195,3,24.4842938945844,2,1,"rope",6,11.2649670107889
0.0244496809318662,9,1.68496089926921,5,10.4123129197133,3,1,"rope",6,10.3878632387814
14.6914933287519,9,26.9209410334924,2,34.7006171483412,6,1,"rope",3,20.0091238195893
16.8527062647956,9,26.9209410334924,2,41.2240082480819,4,1,"rope",5,24.3713019832863
0.828461778409991,10,1,5,13.3438588405556,2,1,"rope",8,12.5153970621456
1.48101441350849,10,10.6982305467626,3,21.765013971945,4,1,"rope",6,20.2839995584365
3.09540678690892,10,10.6982305467626,3,16.5483092162795,7,1,"rope",3,13.4529024293706
0.466644950211048,1,1,1,14.9737746356955,7,1,"rope",6,14.5071296854845
4.53477190227664,1,13.4508889334046,2,31.6537257233686,3,1,"rope",2,27.118953821092
5.81097559326269,1,13.4508889334046,2,47.2861342756795,10,1,"rope",9,41.4751586824168
6.18009145060438,1,13.4508889334046,2,36.2596533212071,7,1,"rope",6,30.0795618706027
6.85139335706714,1,13.4508889334046,2,40.0786153954575,8,1,"rope",7,33.2272220383904
7.12591809104846,1,13.4508889334046,2,45.6504506105868,9,1,"rope",8,38.5245325195383
8.08501828993845,1,13.4508889334046,2,32.6725370671711,4,1,"rope",3,24.5875187772326
10.0519365385376,1,13.4508889334046,2,33.3456127491032,6,1,"rope",5,23.2936762105656
10.4986019028552,1,13.4508889334046,2,47.2861342756795,10,1,"rope",9,36.7875323728243
11.0380250156127,1,13.4508889334046,2,36.2596533212071,7,1,"rope",6,25.2216283055944
0.920738366390479,2,1.7977662734014,1,19.8781178400699,10,1,"rope",8,18.9573794736794
1.7458234602646,2,26.0757710565096,4,47.0519986339384,7,1,"rope",5,45.3061751736738
2.35395643823454,2,26.0757710565096,4,35.5342686693574,4,1,"rope",2,33.1803122311229
2.95488124909485,2,26.0757710565096,4,47.0519986339384,7,1,"rope",5,44.0971173848436
3.09735920429835,2,26.0757710565096,4,41.0683949487947,5,1,"rope",3,37.9710357444963
3.67898151660944,2,26.0757710565096,4,48.103889238183,8,1,"rope",6,44.4249077215736
4.20735609541321,2,26.0757710565096,4,41.699042349375,6,1,"rope",4,37.4916862539618
5.19837049917762,2,26.0757710565096,4,41.0683949487947,5,1,"rope",3,35.8700244496171
5.61839094130681,2,26.0757710565096,4,35.5342686693574,4,1,"rope",2,29.9158777280506
9.55045358185679,2,26.0757710565096,4,47.0519986339384,7,1,"rope",5,37.5015450520816
2.34279567176912,3,3.83445869761796,1,19.8781178400699,10,1,"rope",7,17.5353221683008
3.82314233600134,3,46.1182021702204,5,56.526057909406,5,1,"rope",2,52.7029155734047
4.62191836836244,3,7.64463535653842,4,14.1190285003321,1,1,"rope",2,9.49711013196966
5.83616895152208,3,46.1182021702204,5,56.526057909406,5,1,"rope",2,50.6898889578839
7.08649780880569,3,46.1182021702204,5,63.0517399516049,9,1,"rope",6,55.9652421427992
7.13317884604681,3,26.7202496064528,5,32.7764709293792,1,1,"rope",2,25.6432920833324
11.1703454806127,3,26.7202496064528,5,32.7764709293792,1,1,"rope",2,21.6061254487665
11.9727200032299,3,26.7202496064528,5,32.7764709293792,1,1,"rope",2,20.8037509261493
12.6658625491051,3,46.1182021702204,5,56.526057909406,5,1,"rope",2,43.8601953603009
12.9570739324516,3,46.1182021702204,5,56.526057909406,5,1,"rope",2,43.5689839769544
0.611370072389642,4,5.56048123885818,4,10.8946322951635,2,1,"rope",2,10.2832622227739
6.37232547287452,4,47.0856268071076,3,55.7514209496907,7,1,"rope",3,49.3790954768162
7.18005865746594,4,26.1435908196489,5,32.7764709293792,1,1,"rope",3,25.5964122719133
2.44503577939981,5,12.3555178411619,1,19.1420025012351,9,1,"rope",4,16.6969667218353
12.5664566490643,5,32.9101065693607,3,35.4941440593335,2,1,"rope",3,22.9276874102692
18.977316037394,5,49.1553303255573,3,60.0544855611917,10,1,"rope",5,41.0771695237977
1.62691656810542,6,14.7795443085938,5,32.7764709293792,1,1,"rope",5,31.1495543612738
1.73600244734841,6,14.7795443085938,5,26.1435908196489,4,1,"rope",2,24.4075883723005
7.01135747448407,6,14.7795443085938,5,26.1435908196489,4,1,"rope",2,19.1322333451648
6.31081736308146,7,30.2211767843216,3,35.4941440593335,2,1,"rope",5,29.183326696252
8.86014183320316,7,30.2211767843216,3,32.9101065693607,5,1,"rope",2,24.0499647361575
9.54337867866171,7,30.2211767843216,3,38.7984532787187,1,1,"rope",6,29.255074600057
1.11052479886123,8,5.58221409745595,5,14.7795443085938,6,1,"rope",2,13.6690195097326
2.60584444874881,8,5.58221409745595,5,31.1933432772939,2,1,"rope",6,28.5874988285451
3.63272755077092,8,5.58221409745595,5,14.7795443085938,6,1,"rope",2,11.1468167578229
0.823562871664762,9,2.30490107926387,5,23.4203801556871,5,1,"rope",4,22.5968172840223
8.22040397631836,9,20.7271055319488,3,30.9848875674176,6,1,"rope",3,22.7644835910992
13.1784848058872,9,20.7271055319488,3,30.9848875674176,6,1,"rope",3,17.8064027615304
0.0508667960090449,10,1,5,5.58221409745595,8,1,"rope",2,5.53134730144691
0.301172761410016,10,1,5,23.4203801556871,5,1,"rope",5,23.1192073942771
5.47279267560206,10,19.5807849355505,3,35.4941440593335,2,1,"rope",8,30.0213513837314
0.391290286872362,1,1,1,10.5832507034914,4,1,"rope",3,10.191960416619
1.20704348878442,1,7.46449324122513,2,31.496845959365,7,1,"rope",6,30.2898024705806
1.74908044030397,1,7.46449324122513,2,31.496845959365,7,1,"rope",6,29.747765519061
3.04252679389864,1,7.46449324122513,2,23.5399617087565,5,1,"rope",4,20.4974349148579
3.09286375180781,1,7.46449324122513,2,23.5399617087565,5,1,"rope",4,20.4470979569487
5.25179547549737,1,7.46449324122513,2,24.2123129238843,6,1,"rope",5,18.9605174483869
5.83072141440229,1,7.46449324122513,2,19.9830185290797,4,1,"rope",3,14.1522971146774
6.3417612963693,1,7.46449324122513,2,19.9830185290797,4,1,"rope",3,13.6412572327104
11.0449001430213,1,19.1759248033205,4,34.933575401159,6,1,"rope",5,23.8886752581377
14.2457186219144,1,19.1759248033205,4,37.7212769167421,7,1,"rope",6,23.4755582948277
0.615197817329317,2,1.48084356756881,1,27.5404312325934,9,1,"rope",7,26.9252334152641
2.99355275590408,2,20.423511444688,4,54.2447605211361,10,1,"rope",8,51.251207765232
4.03611749533524,2,20.423511444688,4,37.7212769167421,7,1,"rope",5,33.6851594214069
4.38064326235985,2,20.423511444688,4,51.2926650516737,9,1,"rope",7,46.9120217893139
4.74055181566586,2,20.423511444688,4,54.2447605211361,10,1,"rope",8,49.5042087054702
6.36618576685838,2,20.423511444688,4,26.0738790681867,4,1,"rope",2,19.7076933013283
7.69332334509515,2,20.423511444688,4,26.0738790681867,4,1,"rope",2,18.3805557230915
7.95343607075908,2,20.423511444688,4,26.0738790681867,4,1,"rope",2,18.1204429974276
8.30197062323526,2,20.423511444688,4,51.2926650516737,9,1,"rope",7,42.9906944284384
8.99077988349558,2,20.423511444688,4,42.8292644242828,8,1,"rope",6,33.8384845407872
0.427190017862712,3,3.44017954107154,1,27.5404312325934,9,1,"rope",6,27.1132412147307
0.8463359935903,3,6.14877443735428,4,12.560172385047,1,1,"rope",2,11.7138363914567
2.75939183959919,3,3.44017954107154,1,12.9076528209211,6,1,"rope",3,10.1482609813219
3.6043134042405,3,32.4854235989075,5,42.5541981713897,7,1,"rope",4,38.9498847671492
3.97953423246447,3,32.4854235989075,5,42.5541981713897,7,1,"rope",4,38.5746639389252
4.07291422626919,3,32.4854235989075,5,47.3583602746737,10,1,"rope",7,43.2854460484045
5.27420064275853,3,32.4854235989075,5,45.7634270653405,9,1,"rope",6,40.489226422582
5.96540793897352,3,32.4854235989075,5,38.8038913380612,5,1,"rope",2,32.8384833990877
6.35790212386987,3,32.4854235989075,5,47.3583602746737,10,1,"rope",7,41.0004581508038
9.24929434824448,3,32.4854235989075,5,38.8038913380612,5,1,"rope",2,29.5545969898167
4.25839924860402,4,10.5832507034914,1,12.9076528209211,6,1,"rope",2,8.64925357231708
4.33769546900843,4,10.5832507034914,1,30.9711897441756,10,1,"rope",6,26.6334942751672
7.69587297740636,4,15.1882367097729,5,21.9916444308645,1,1,"rope",3,14.2957714534581
9.72975321058051,5,12.7371343584512,5,21.1260529991101,2,1,"rope",3,11.3962997885296
10.6079569313662,5,12.7371343584512,5,21.1260529991101,2,1,"rope",3,10.5180960677439
12.3501484121493,5,23.5399617087565,2,31.496845959365,7,1,"rope",2,19.1466975472157
2.28879847098142,6,3.01227015434744,3,10.2008939424985,9,1,"rope",3,7.91209547151708
3.13025685337683,6,12.9076528209211,1,30.9711897441756,10,1,"rope",4,27.8409328907988
3.39164600707591,6,12.9076528209211,1,30.9711897441756,10,1,"rope",4,27.5795437370997
3.00795367904906,7,31.496845959365,2,34.1470264015397,10,1,"rope",3,31.1390727224906
6.92109188036927,7,7.25362687852591,5,20.4324508966971,3,1,"rope",4,13.5113590163278
8.0822020219883,7,38.8014315637418,1,47.11001518295,1,1,"rope",6,39.0278131609617
0.643088817596436,8,4.58885305885749,5,21.1260529991101,2,1,"rope",6,20.4829641815137
4.66948201244974,8,36.1565003395579,1,45.2839313363987,3,1,"rope",5,40.614449323949
7.87843625964531,8,36.1565003395579,1,45.2839313363987,3,1,"rope",5,37.4054950767534
2.51273965138598,9,16.9815103583872,3,28.2803726105636,1,1,"rope",8,25.7676329591776
2.91887244195644,9,16.9815103583872,3,21.3759043748309,5,1,"rope",4,18.4570319328745
3.54520090375994,9,16.9815103583872,3,26.5769457975096,2,1,"rope",7,23.0317448937497
6.12660973615257,10,15.0461488998184,3,28.2803726105636,1,1,"rope",9,22.153762874411
6.13578691429703,10,15.0461488998184,3,23.3546812326931,3,1,"rope",7,17.2188943183961
18.9888817186289,10,33.9507452392465,1,38.8014315637418,7,1,"rope",3,19.8125498451129
0.724805733400816,1,1,1,2.3536549553587,3,1,"rope",2,1.62884922195788
1.06666706197658,1,10.597756934156,4,41.3183771051777,10,1,"rope",9,40.2517100432011
2.73337043694894,1,10.597756934156,4,39.3309105827093,9,1,"rope",8,36.5975401457604
3.90624232179684,1,10.597756934156,4,36.6104056321189,8,1,"rope",7,32.7041633103221
4.52617474747089,1,10.597756934156,4,34.2512110180211,6,1,"rope",5,29.7250362705502
4.76911208414671,1,10.597756934156,4,35.9418710022692,7,1,"rope",6,31.1727589181225
7.16773248273582,1,10.597756934156,4,35.9418710022692,7,1,"rope",6,28.7741385195334
7.39913558676542,1,10.597756934156,4,36.6104056321189,8,1,"rope",7,29.2112700453535
9.82741444820677,1,10.597756934156,4,41.3183771051777,10,1,"rope",9,31.4909626569709
9.90423105780174,1,10.597756934156,4,29.16170930976,4,1,"rope",3,19.2574782519583
4.21692170550056,2,15.8252196036957,2,23.3100655624555,8,1,"rope",6,19.0931438569549
4.69304200748853,2,15.8252196036957,2,21.631849990587,5,1,"rope",3,16.9388079830985
5.86162490353999,2,15.8252196036957,2,22.7677666003444,7,1,"rope",5,16.9061416968044
8.07881672238743,2,15.8252196036957,2,35.1405641593806,10,1,"rope",8,27.0617474369932
9.43477768750198,2,15.8252196036957,2,22.7677666003444,7,1,"rope",5,13.3329889128424
11.7166371386616,2,15.8252196036957,2,19.1714615777323,4,1,"rope",2,7.4548244390707
12.0042180827936,2,15.8252196036957,2,27.3011558364709,9,1,"rope",7,15.2969377536773
14.0685007030353,2,15.8252196036957,2,21.7068874706163,6,1,"rope",4,7.638386767581
14.7090459906705,2,15.8252196036957,2,27.3011558364709,9,1,"rope",7,12.5921098458004
15.4329138770137,2,37.7736331566495,3,56.1355345468022,8,1,"rope",6,40.7026206697885
0.246018036068244,3,2.3536549553587,1,16.5804640716541,10,1,"rope",7,16.3344460355859
1.09852735115188,3,2.3536549553587,1,5.76347824398378,5,1,"rope",2,4.6649508928319
1.15158223188234,3,2.3536549553587,1,14.0448784418737,8,1,"rope",5,12.8932962099914
1.40922655923976,3,2.3536549553587,1,15.2117325937242,9,1,"rope",6,13.8025060344844
2.95593128172413,3,3.78402233940187,4,5.49283395145995,1,1,"rope",2,2.53690266973582
5.020146796449,3,40.0433997923815,3,51.7335300441845,6,1,"rope",3,46.7133832477355
8.65141761278862,3,40.0433997923815,3,59.5845861248896,10,1,"rope",7,50.933168512101
9.85388624174173,3,40.0433997923815,3,52.712246542286,7,1,"rope",4,42.8583603005443
10.7061063793033,3,40.0433997923815,3,52.712246542286,7,1,"rope",4,42.0061401629827
11.1666690382652,3,40.0433997923815,3,52.712246542286,7,1,"rope",4,41.5455775040208
0.704820294243594,4,3.09862186405925,1,16.5804640716541,10,1,"rope",6,15.8756437774105
1.67044585105032,4,3.09862186405925,1,15.2117325937242,9,1,"rope",5,13.5412867426739
7.20856346893562,4,48.5328584567379,5,52.2063103045335,6,1,"rope",2,44.9977468355979
0.160652987348537,5,1,3,4.37079285269437,7,1,"rope",2,4.21013986534583
1.84619682530562,5,49.9727664160915,5,54.9934757068826,8,1,"rope",3,53.147278881577
3.92197034011284,5,14.7336216484539,5,24.6599677321329,2,1,"rope",3,20.7379973920201
2.44126581866456,6,9.29646723254515,5,20.4499630561927,3,1,"rope",3,18.0086972375281
13.9668305333707,6,19.551672779348,3,27.9145779822303,2,1,"rope",4,13.9477474488596
14.4682757996552,6,19.551672779348,3,30.3559419988784,1,1,"rope",5,15.8876661992232
0.103664728812873,7,7.42660230470752,5,20.4499630561927,3,1,"rope",4,20.3462983273798
0.125027413766516,7,7.42660230470752,5,18.0417780101981,4,1,"rope",3,17.9167505964316
5.6442343657901,7,52.712246542286,3,57.6964129526854,9,1,"rope",2,52.0521785868953
3.46684715696577,8,5.42035120866339,5,9.29646723254515,6,1,"rope",2,5.82962007557938
17.2767551576388,8,29.2204199123033,1,49.153742893581,1,1,"rope",7,31.8769877359422
17.3767411234769,8,29.2204199123033,1,38.551422990567,2,1,"rope",6,21.1746818670901
8.01050352295438,9,11.3183882876446,3,25.4102998043286,4,1,"rope",5,17.3997962813742
10.1383530027812,9,11.3183882876446,3,25.4102998043286,4,1,"rope",5,15.2719468015474
11.66151003654,9,28.5506055956855,1,35.1524694874992,5,1,"rope",4,23.4909594509592
0.288200083499153,10,1,5,5.42035120866339,8,1,"rope",2,5.13215112516424
0.339065040246844,10,1,5,20.4499630561927,3,1,"rope",7,20.1108980159459
1.0107054279831,10,7.85820303563918,3,30.3559419988784,1,1,"rope",9,29.3452365708953
2.11232387075636,1,7.35551825513072,2,19.1799329155833,10,1,"rope",9,17.0676090448269
2.95926728242625,1,7.35551825513072,2,16.4472655752519,8,1,"rope",7,13.4879982928257
3.62020630392794,1,7.35551825513072,2,12.860007728472,6,1,"rope",5,9.23980142454406
5.65269403527088,1,7.35551825513072,2,15.6985052478639,7,1,"rope",6,10.045811212593
6.0438441684895,1,7.35551825513072,2,17.0361510219363,9,1,"rope",8,10.9923068534468
6.96232179775887,1,7.35551825513072,2,11.8323628670435,5,1,"rope",4,4.87004106928463
7.1335815320728,1,16.1831422012817,4,38.1414720814816,10,1,"rope",9,31.0078905494088
7.69404678037443,1,16.1831422012817,4,31.5136767197765,7,1,"rope",6,23.8196299394021
8.58436702085236,1,16.1831422012817,4,31.9409081624587,8,1,"rope",7,23.3565411416063
8.73340225320451,1,16.1831422012817,4,29.2367391470997,5,1,"rope",4,20.5033368938952
0.468232573749312,2,1.5205982318148,1,6.05400066588802,7,1,"rope",5,5.58576809213871
1.09755872636456,2,20.4138092033748,4,31.5136767197765,7,1,"rope",5,30.4161179934119
1.25517475008853,2,20.4138092033748,4,30.8546581360579,6,1,"rope",4,29.5994833859694
3.280559503947,2,20.4138092033748,4,38.1414720814816,10,1,"rope",8,34.8609125775346
5.5861900781903,2,20.4138092033748,4,30.8546581360579,6,1,"rope",4,25.2684680578676
7.02758196338689,2,36.4836269709393,5,45.5612009930419,7,1,"rope",5,38.533619029655
7.61708315012654,2,36.4836269709393,5,43.0066553012834,6,1,"rope",4,35.3895721511569
7.672339858186,2,36.4836269709393,5,53.4871129733323,10,1,"rope",8,45.8147731151463
9.1153936680279,2,36.4836269709393,5,50.7619266992157,8,1,"rope",6,41.6465330311878
9.40804762820371,2,36.4836269709393,5,53.4871129733323,10,1,"rope",8,44.0790653451286
0.125097025957672,3,3.21126015042158,1,16.8600901314289,10,1,"rope",7,16.7349931054712
1.01810567433355,3,3.21126015042158,1,6.05400066588802,7,1,"rope",4,5.03589499155447
1.1427702441669,3,3.21126015042158,1,7.96695587167933,8,1,"rope",5,6.82418562751243
2.43141597820408,3,3.21126015042158,1,14.9492087309236,9,1,"rope",6,12.5177927527195
4.06614410902587,3,43.0064685374792,3,50.6867937842115,6,1,"rope",3,46.6206496751856
6.61322019448222,3,43.0064685374792,3,52.7834767683231,7,1,"rope",4,46.1702565738409
8.85031720623528,3,43.0064685374792,3,58.4708529965793,8,1,"rope",5,49.620535790344
8.98165358231825,3,43.0064685374792,3,50.6867937842115,6,1,"rope",3,41.7051402018933
9.13500134275717,3,43.0064685374792,3,61.3201602664709,9,1,"rope",6,52.1851589237137
9.40960072308269,3,43.0064685374792,3,52.7834767683231,7,1,"rope",4,43.3738760452404
2.19456815471252,4,53.9283513193341,1,69.9632614026625,10,1,"rope",6,67.76869324795
4.49049396906048,4,24.1295953402693,5,33.5625164656479,1,1,"rope",3,29.0720224965874
11.8855404866488,4,53.9283513193341,1,59.1212064223066,6,1,"rope",2,47.2356659356578
0.952421764229475,5,1,3,5.65063658402948,8,1,"rope",3,4.69821481980001
7.6372320099799,5,30.0449688233222,1,45.3042677579421,1,1,"rope",4,37.6670357479622
10.0940189590274,5,30.0449688233222,1,45.3042677579421,1,1,"rope",4,35.2102487989147
2.67862619197273,6,64.0553955273788,2,68.1144101219134,8,1,"rope",2,65.4357839299407
13.320645726517,6,26.9564580142532,3,32.8104481967389,4,1,"rope",2,19.4898024702219
13.992574813386,6,26.9564580142532,3,36.4668168335708,2,1,"rope",4,22.4742420201848
0.348606030884896,7,11.9187494314126,5,24.1295953402693,4,1,"rope",3,23.7809893093844
2.86222494391357,7,11.9187494314126,5,26.3634271556321,3,1,"rope",4,23.5012022117185
5.79786594748531,7,11.9187494314126,5,33.5625164656479,1,1,"rope",6,27.7646505181626
3.65756078919673,8,4.04404681798541,5,22.8131292173105,5,1,"rope",3,19.1555684281138
4.76522429021407,8,24.601205914512,1,30.0449688233222,5,1,"rope",3,25.2797445331081
15.9979933567427,8,24.601205914512,1,31.7907901168511,3,1,"rope",5,15.7927967601084
1.59607481211424,9,3.00943371628882,5,26.3634271556321,3,1,"rope",6,24.7673523435179
7.53732733400472,9,18.9482778508875,3,28.9534857129803,5,1,"rope",4,21.4161583789756
11.0051792141816,9,18.9482778508875,3,38.5880436946,1,1,"rope",8,27.5828644804184
1.98990350278715,10,15.8033841847678,3,28.9534857129803,5,1,"rope",5,26.9635822101931
4.0111461483563,10,15.8033841847678,3,21.717117455368,7,1,"rope",3,17.7059713070117
9.97511427976746,10,15.8033841847678,3,32.8104481967389,4,1,"rope",6,22.8353339169714
0.0655843946151435,1,1,1,19.135654889185,9,1,"rope",8,19.0700704945699
0.939702483317715,1,1,1,2.57483346044104,3,1,"rope",2,1.63513097712332
2.92980930801917,1,18.6364635250209,4,26.8713471632754,6,1,"rope",5,23.9415378552562
3.38277685070846,1,18.6364635250209,4,29.5554985082984,7,1,"rope",6,26.1727216575899
4.62534962484573,1,18.6364635250209,4,22.6160119302546,3,1,"rope",2,17.9906623054089
5.2174767081808,1,18.6364635250209,4,31.451392363703,9,1,"rope",8,26.2339156555222
5.83925768203994,1,18.6364635250209,4,25.9027171238394,5,1,"rope",4,20.0634594417995
5.96615552454029,1,18.6364635250209,4,29.5554985082984,7,1,"rope",6,23.5893429837581
6.08130116109222,1,18.6364635250209,4,24.1445744420701,4,1,"rope",3,18.0632732809779
7.31931488212139,1,18.6364635250209,4,30.8848119842703,8,1,"rope",7,23.5654971021489
0.409973036963493,2,2.12596381670814,1,8.17876776359542,5,1,"rope",3,7.76879472663193
0.448180267969466,2,2.12596381670814,1,8.17876776359542,5,1,"rope",3,7.73058749562595
1.0936401327237,2,2.12596381670814,1,18.6508423456552,8,1,"rope",6,17.5572022129315
1.25826950595746,2,2.12596381670814,1,19.135654889185,9,1,"rope",7,17.8773853832275
2.12066712916385,2,8.44610746951525,2,12.0995632836264,4,1,"rope",2,9.97889615446255
2.42039116691481,2,8.44610746951525,2,12.6634480317053,5,1,"rope",3,10.2430568647905
2.57953486331386,2,8.44610746951525,2,12.6634480317053,5,1,"rope",3,10.0839131683914
4.25637434899434,2,8.44610746951525,2,13.2019323061724,7,1,"rope",5,8.94555795717806
6.09576978489888,2,8.44610746951525,2,12.8657446765844,6,1,"rope",4,6.76997489168552
6.12988267375199,2,8.44610746951525,2,15.4581889182287,10,1,"rope",8,9.32830624447671
2.32430685485218,3,46.6546139373253,5,64.8867622781812,9,1,"rope",6,62.562455423329
4.3233539497242,3,46.6546139373253,5,58.7760295223161,7,1,"rope",4,54.4526755725919
5.13154948570706,3,46.6546139373253,5,56.8945966084944,6,1,"rope",3,51.7630471227873
9.21946804086102,3,46.6546139373253,5,66.3548009427531,10,1,"rope",7,57.1353329018921
11.6616404767786,3,46.6546139373253,5,56.8945966084944,6,1,"rope",3,45.2329561317158
13.7378103307246,3,46.6546139373253,5,64.8867622781812,9,1,"rope",6,51.1489519474566
14.7600607464399,3,46.6546139373253,5,50.4557411410026,5,1,"rope",2,35.6956803945627
15.8964288301655,3,46.6546139373253,5,56.8945966084944,6,1,"rope",3,40.9981677783289
16.3316477869174,3,46.6546139373253,5,66.3548009427531,10,1,"rope",7,50.0231531558357
16.8396053268494,3,29.9075005415805,5,34.3200982362713,1,1,"rope",2,17.4804929094219
1.01439194971782,4,51.0102568515747,1,63.8286974678624,10,1,"rope",6,62.8143055181446
3.31321115978769,4,27.1329320751178,5,32.6355321847379,2,1,"rope",2,29.3223210249502
4.39805486457509,4,51.0102568515747,1,58.1029628689642,6,1,"rope",2,53.7049080043891
0.773718861552576,5,1,4,8.4726860454523,3,1,"rope",2,7.69896718389972
1.43150203265326,5,23.6158733927566,5,29.9075005415805,3,1,"rope",2,28.4759985089272
2.05437305097855,5,8.17876776359542,1,15.3988145947137,7,1,"rope",2,13.3444415437352
1.17265121390422,6,3.3100966195667,3,13.0045380951538,9,1,"rope",3,11.8318868812496
2.23930198233575,6,21.965717340575,5,27.1329320751178,4,1,"rope",2,24.8936300927821
2.4892491583402,6,3.3100966195667,3,14.1230149162586,10,1,"rope",4,11.6337657579184
0.219002321052055,7,6.60122575208849,3,14.1230149162586,10,1,"rope",3,13.9040125952065
3.96557149928961,7,13.2115766904034,5,23.6158733927566,5,1,"rope",2,19.650301893467
5.55144130393519,7,13.2115766904034,5,23.6158733927566,5,1,"rope",2,18.0644320888214
5.10408457340606,8,9.89301573792317,3,14.1230149162586,10,1,"rope",2,9.01893034285254
5.53758675980626,8,6.78810514899662,5,34.3200982362713,1,1,"rope",7,28.782511476465
11.9044323213385,8,33.9524133833798,3,44.1879553715208,3,1,"rope",5,32.2835230501823
1.20940175062666,9,5.18941844871979,5,27.1329320751178,4,1,"rope",5,25.9235303244911
9.72297712652844,9,19.7120681415147,3,43.7810309763973,4,1,"rope",5,34.0580538498689
16.6195876097756,9,19.7120681415147,3,46.0683929348896,2,1,"rope",7,29.448805325114
0.00253401153380378,10,1,5,13.2115766904034,7,1,"rope",3,13.2090426788696
5.29788358807467,10,18.2606004815384,3,36.3180511877826,6,1,"rope",4,31.0201675997079
7.59688988998436,10,18.2606004815384,3,36.3180511877826,6,1,"rope",4,28.7211612977982
0.335494593251497,1,1,1,27.0582127578376,9,1,"rope",8,26.7227181645861
0.994422734715044,1,1,1,16.5738628329741,7,1,"rope",6,15.5794400982591
2.22285277205975,1,11.3916223475828,4,17.6628361490225,6,1,"rope",5,15.4399833769628
2.44447982307048,1,11.3916223475828,4,17.274531403126,5,1,"rope",4,14.8300515800555
3.9035746588646,1,11.3916223475828,4,19.3151417477153,7,1,"rope",6,15.4115670888507
5.84078795724654,1,11.3916223475828,4,17.6628361490225,6,1,"rope",5,11.822048191776
6.11707157810324,1,11.3916223475828,4,19.3151417477153,7,1,"rope",6,13.1980701696121
6.76876324578137,1,11.3916223475828,4,22.9621551708789,8,1,"rope",7,16.1933919250975
7.79325901316883,1,11.3916223475828,4,17.274531403126,5,1,"rope",4,9.48127238995717
8.5482939026818,1,11.3916223475828,4,15.9181586347005,3,1,"rope",2,7.3698647320187
0.761364003285117,2,4.71424442778554,1,17.9530455136115,8,1,"rope",6,17.1916815103264
0.874539989619798,2,4.71424442778554,1,14.987984764098,6,1,"rope",4,14.1134447744782
2.83867912136492,2,4.71424442778554,1,30.3156287535794,10,1,"rope",8,27.4769496322145
4.57724442094087,2,13.6552090020496,2,24.0856492427374,5,1,"rope",3,19.5084048217965
6.61849790564241,2,13.6552090020496,2,25.1736133609302,7,1,"rope",5,18.5551154552878
7.29619068218829,2,13.6552090020496,2,31.8239666493054,10,1,"rope",8,24.5277759671171
9.20387829398219,2,13.6552090020496,2,27.1708598350601,8,1,"rope",6,17.9669815410779
11.3157302318504,2,13.6552090020496,2,20.9835623968605,4,1,"rope",2,9.6678321650101
11.9344283787881,2,13.6552090020496,2,25.1736133609302,7,1,"rope",5,13.2391849821421
12.5505463162785,2,13.6552090020496,2,31.8239666493054,10,1,"rope",8,19.2734203330269
0.603368536103517,3,3.4172828363284,4,6.75504637415815,1,1,"rope",2,6.15167783805463
3.77047979861458,3,40.5048826313529,5,49.4653673937516,8,1,"rope",5,45.694887595137
5.35809482096635,3,40.5048826313529,5,53.0806943522052,10,1,"rope",7,47.7225995312388
5.42549986925848,3,40.5048826313529,5,47.7045733883925,7,1,"rope",4,42.279073519134
6.81623110846438,3,40.5048826313529,5,49.4653673937516,8,1,"rope",5,42.6491362852872
6.87184231561142,3,40.5048826313529,5,45.7291211678456,6,1,"rope",3,38.8572788522342
6.96540228249969,3,40.5048826313529,5,47.7045733883925,7,1,"rope",4,40.7391711058928
8.72105314360445,3,27.2852958673588,5,33.6543300703225,1,1,"rope",2,24.9332769267181
8.97432969759881,3,40.5048826313529,5,47.7045733883925,7,1,"rope",4,38.7302436907937
9.43929298412853,3,40.5048826313529,5,43.3140812051434,5,1,"rope",2,33.8747882210149
1.07175515654186,4,52.0062981316172,3,56.1602011024945,6,1,"rope",2,55.0884459459526
3.64131860528642,4,43.2541840242753,3,45.0474218139025,2,1,"rope",2,41.4061032086161
6.76376927413203,4,52.0062981316172,3,64.0945116963648,9,1,"rope",5,57.3307424222328
2.26642248841623,5,55.4602981897883,3,60.60052243716,8,1,"rope",3,58.3340999487438
3.89097901216398,5,55.4602981897883,3,60.1459520861891,7,1,"rope",2,56.2549730740251
5.50062370641778,5,42.3753610903224,3,45.9610726073477,1,1,"rope",4,40.4604489009299
0.617362310489019,6,4.33373189700728,3,8.22095317913752,10,1,"rope",4,7.6035908686485
2.81088508820782,6,4.33373189700728,3,8.22095317913752,10,1,"rope",4,5.4100680909297
4.59934432680408,6,15.7705998917818,5,26.3850813620467,4,1,"rope",2,21.7857370352426
3.67918221576417,7,12.2383127645008,5,33.6543300703225,1,1,"rope",6,29.9751478545583
7.06814832026073,7,12.2383127645008,5,27.2852958673588,3,1,"rope",4,20.2171475470981
8.35896023210693,7,16.5738628329741,1,30.3156287535794,10,1,"rope",3,21.9566685214725
13.4910224228697,8,17.9530455136115,1,30.3156287535794,10,1,"rope",2,16.8246063307097
15.1439441699755,8,17.9530455136115,1,30.3156287535794,10,1,"rope",2,15.1716845836039
16.1407174967449,8,17.9530455136115,1,30.3156287535794,10,1,"rope",2,14.1749112568345
0.0107111964483092,9,5.22058231120869,5,33.6543300703225,1,1,"rope",8,33.6436188738742
6.29599666779636,9,36.4170270305569,2,46.8920284990501,6,1,"rope",3,40.5960318312537
14.0545255369754,9,36.4170270305569,2,51.1690862631778,3,1,"rope",6,37.1145607262024
0.247813854489474,10,1,5,31.9381709135891,2,1,"rope",8,31.6903570590996
1.43323215564185,10,41.6152163327399,4,51.7714499463547,6,1,"rope",4,50.3382177907128
7.78696219937903,10,41.6152163327399,4,49.6270353389334,7,1,"rope",3,41.8400731395544
1.61438449461997,1,4.51438396583885,2,15.8993130349015,5,1,"rope",4,14.2849285402815
2.28143845022708,1,4.51438396583885,2,15.0900619141592,4,1,"rope",3,12.8086234639321
2.4459026371041,1,4.51438396583885,2,15.8993130349015,5,1,"rope",4,13.4534103977974
2.75122797339276,1,4.51438396583885,2,9.49407142758724,3,1,"rope",2,6.74284345419448
2.88330226614192,1,4.51438396583885,2,15.8993130349015,5,1,"rope",4,13.0160107687596
3.71840677070008,1,4.51438396583885,2,9.49407142758724,3,1,"rope",2,5.77566465688716
4.67650171583551,1,11.8572663282044,4,32.9211788411419,10,1,"rope",9,28.2446771253064
4.72251354124867,1,11.8572663282044,4,27.8203262012808,9,1,"rope",8,23.0978126600321
5.90809243507678,1,11.8572663282044,4,25.0828741940002,6,1,"rope",5,19.1747817589234
7.00797996442284,1,11.8572663282044,4,25.7600869023531,7,1,"rope",6,18.7521069379303
2.3064425285144,2,7.65063232149849,1,18.7869389178595,6,1,"rope",4,16.4804963893451
2.34863535016784,2,7.65063232149849,1,28.5405292784019,10,1,"rope",8,26.1918939282341
5.56036244017972,2,7.65063232149849,1,13.2594716278034,4,1,"rope",2,7.69910918762368
5.96075324119969,2,7.65063232149849,1,14.7394838553286,5,1,"rope",3,8.77873061412891
6.11448052024437,2,7.65063232149849,1,28.5405292784019,10,1,"rope",8,22.4260487581575
8.93610345799405,2,13.3326314831226,4,25.7600869023531,7,1,"rope",5,16.823983444359
9.02768989762177,2,13.3326314831226,4,21.8885314844562,5,1,"rope",3,12.8608415868344
9.09932190382738,2,13.3326314831226,4,26.4728886262385,8,1,"rope",6,17.3735667224111
10.0341778923257,2,13.3326314831226,4,21.8885314844562,5,1,"rope",3,11.8543535921305
10.1840506577364,2,36.4274888401086,5,55.3087225868021,9,1,"rope",7,45.1246719290657
3.72714271189129,3,41.1361361092563,5,55.3087225868021,9,1,"rope",6,51.5815798749108
3.75931019361547,3,41.1361361092563,5,47.4442466377604,5,1,"rope",2,43.6849364441449
5.74933490360552,3,41.1361361092563,5,49.4934281689047,8,1,"rope",5,43.7440932652992
6.66919885783464,3,41.1361361092563,5,48.807220612291,6,1,"rope",3,42.1380217544564
6.84909030429011,3,41.1361361092563,5,59.3347460264173,10,1,"rope",7,52.4856557221272
7.20136906832673,3,18.473612001168,5,29.8425265162054,1,1,"rope",2,22.6411574478787
10.1531689451466,3,41.1361361092563,5,49.4934281689047,8,1,"rope",5,39.3402592237581
10.7486462896149,3,41.1361361092563,5,48.807220612291,6,1,"rope",3,38.0585743226761
12.9106315612998,3,41.1361361092563,5,49.4934281689047,8,1,"rope",5,36.5827966076049
13.3778132834676,3,18.473612001168,5,29.8425265162054,1,1,"rope",2,16.4647132327378
0.309971350555619,4,15.0900619141592,2,28.9176137057642,9,1,"rope",5,28.6076423552086
3.61189182523294,4,17.0972463760548,5,29.8425265162054,1,1,"rope",3,26.2306346909725
10.1794658814392,4,15.0900619141592,2,25.141045047323,7,1,"rope",3,14.9615791658838
4.04963835438991,5,14.7394838553286,1,28.5405292784019,10,1,"rope",5,24.490890924012
11.148472223489,5,14.7394838553286,1,20.2829984146095,8,1,"rope",3,9.1345261911205
21.9460639290458,5,53.8239483424752,3,72.0948696139698,8,1,"rope",3,50.148805684924
6.8315435198129,6,22.1305154369218,2,27.5871991168748,8,1,"rope",2,20.7556555970619
11.5930686699213,6,26.2826406506929,3,28.2803539723081,3,1,"rope",3,16.6872853023868
13.3685685595484,6,22.1305154369218,2,34.4136093005837,10,1,"rope",4,21.0450407410353
0.858723241835833,7,9.29648817067463,5,17.0972463760548,4,1,"rope",3,16.238523134219
1.98864156535516,7,2.1916854668914,3,6.91016408541952,10,1,"rope",3,4.92152252006436
8.06611135729212,7,9.29648817067463,5,13.6942121659477,5,1,"rope",2,5.62810080865558
12.0394551933261,8,18.9717284358443,3,26.2826406506929,6,1,"rope",2,14.2431854573668
14.5794785172128,8,18.9717284358443,3,29.1602993897786,2,1,"rope",6,14.5808208725658
16.4922663862314,8,18.9717284358443,3,30.5047331041278,1,1,"rope",7,14.0124667178964
0.958436242463586,9,6.30629476340175,5,13.6942121659477,5,1,"rope",4,12.7357759234841
3.9274282589122,9,6.30629476340175,5,17.0972463760548,4,1,"rope",5,13.1698181171426
5.77670998706621,9,6.30629476340175,5,13.6942121659477,5,1,"rope",4,7.91750217888149
0.670102657750249,10,1,5,27.3302028334338,2,1,"rope",8,26.6601001756835
3.0304442992002,10,15.50098422893,3,18.9717284358443,8,1,"rope",2,15.9412841366441
4.42218575100752,10,15.50098422893,3,30.5047331041278,1,1,"rope",9,26.0825473531203
0.638481938280165,1,1,1,9.69430160515282,5,1,"rope",4,9.05581966687265
3.75118461811439,1,7.10763031498469,2,24.836462734782,10,1,"rope",9,21.0852781166676
4.74411863644587,1,7.10763031498469,2,11.5517537944009,3,1,"rope",2,6.80763515795503
5.4421575612628,1,7.10763031498469,2,18.4327547659019,7,1,"rope",6,12.9905972046391
5.87434975104191,1,7.10763031498469,2,24.836462734782,10,1,"rope",9,18.9621129837401
6.3028099117779,1,7.10763031498469,2,18.4327547659019,7,1,"rope",6,12.129944854124
6.58967603888254,1,7.10763031498469,2,13.6915182606389,5,1,"rope",4,7.10184222175636
7.74337531745581,1,16.7964011365149,4,43.7145233232107,8,1,"rope",7,35.9711480057549
9.38311856979895,1,16.7964011365149,4,48.9178791220618,9,1,"rope",8,39.5347605522628
12.0593342201867,1,16.7964011365149,4,48.9178791220618,9,1,"rope",8,36.8585449018751
1.65763987033608,2,2.47646190294335,1,9.69430160515282,5,1,"rope",3,8.03666173481674
4.19758088493204,2,20.2391727179366,4,32.7464506057238,4,1,"rope",2,28.5488697207918
5.16658679650105,2,20.2391727179366,4,41.2626231168389,7,1,"rope",5,36.0960363203379
6.21500509296008,2,20.2391727179366,4,57.2730137086316,10,1,"rope",8,51.0580086156715
6.31202553235319,2,20.2391727179366,4,41.2626231168389,7,1,"rope",5,34.9505975844857
6.48747013951045,2,20.2391727179366,4,57.2730137086316,10,1,"rope",8,50.7855435691212
10.1516411145474,2,20.2391727179366,4,32.7464506057238,4,1,"rope",2,22.5948094911764
10.5068901656547,2,20.2391727179366,4,57.2730137086316,10,1,"rope",8,46.7661235429769
11.687663163983,2,20.2391727179366,4,34.9243060223718,5,1,"rope",3,23.2366428583888
13.2484892661706,2,20.2391727179366,4,34.9243060223718,5,1,"rope",3,21.6758167562012
0.85513713858546,3,3.30532252582906,1,11.1679147238591,6,1,"rope",3,10.3127775852736
3.00349305646454,3,35.3268368184201,5,47.6572145950167,6,1,"rope",3,44.6537215385522
3.24506432681658,3,35.3268368184201,5,47.6572145950167,6,1,"rope",3,44.4121502682001
3.40326023543192,3,35.3268368184201,5,61.0975587563936,10,1,"rope",7,57.6942985209617
4.65064394538685,3,35.3268368184201,5,61.0975587563936,10,1,"rope",7,56.4469148110067
5.4324608618851,3,35.3268368184201,5,47.6572145950167,6,1,"rope",3,42.2247537331316
6.95304374735138,3,35.3268368184201,5,50.1183021114393,8,1,"rope",5,43.1652583640879
7.10202103538572,3,35.3268368184201,5,47.6572145950167,6,1,"rope",3,40.555193559631
10.0411898386115,3,35.3268368184201,5,61.0975587563936,10,1,"rope",7,51.0563689177821
10.6541268121833,3,35.3268368184201,5,58.6718176767173,9,1,"rope",6,48.017690864534
2.97165847058996,4,7.15813161839124,4,14.0238160074385,1,1,"rope",3,11.0521575368485
3.87448700706611,4,7.94264011501606,1,22.8145724957987,8,1,"rope",4,18.9400854887326
4.22154640689719,4,7.94264011501606,1,11.1679147238591,6,1,"rope",2,6.94636831696191
1.51120000561264,5,9.69430160515282,1,22.8145724957987,8,1,"rope",3,21.3033724901861
6.27504465184604,5,9.69430160515282,1,19.0575487245654,7,1,"rope",2,12.7825040727194
6.78410021192465,5,15.2720371018237,5,22.9280533988645,2,1,"rope",3,16.1439531869399
3.95371050249442,6,11.1679147238591,1,25.4276984927048,9,1,"rope",3,21.4739879902104
8.13909284432042,6,11.1679147238591,1,22.8145724957987,8,1,"rope",2,14.6754796514783
8.44593595064489,6,11.1679147238591,1,22.8145724957987,8,1,"rope",2,14.3686365451538
9.56772210641321,7,18.4327547659019,2,24.263357544519,9,1,"rope",2,14.6956354381058
12.0950056324021,7,36.8961757492072,2,40.6380044941385,4,1,"rope",3,28.5429988617364
16.9644060426958,7,18.4327547659019,2,24.836462734782,10,1,"rope",3,7.8720566920862
3.06279408858484,8,6.56606490512319,5,17.9687479076025,3,1,"rope",5,14.9059538190177
16.6742060058394,8,31.0798914587959,2,50.5581580998168,1,1,"rope",7,33.8839520939774
21.8396552138174,8,31.0798914587959,2,45.8613118021677,2,1,"rope",6,24.0216565883503
2.9976185937564,9,21.4562108465605,3,37.036941386956,2,1,"rope",7,34.0393227931996
3.96222632829998,9,21.4562108465605,3,26.6295690627247,6,1,"rope",3,22.6673427344247
7.08194294297895,9,21.4562108465605,3,38.6470779864642,1,1,"rope",8,31.5651350434852
1.87354877746354,10,20.7588537796763,3,38.6470779864642,1,1,"rope",9,36.7735292090007
5.22258179518648,10,20.7588537796763,3,37.036941386956,2,1,"rope",8,31.8143595917695
8.46055609726878,10,20.7588537796763,3,26.6295690627247,6,1,"rope",4,18.1690129654559
0.791030982574246,1,1,1,9.70991385262801,7,1,"rope",6,8.91888287005376
0.803282257324495,1,1,1,4.69735850769092,4,1,"rope",3,3.89407625036643
1.50593326810872,1,5.45009913566502,2,15.3171793255653,4,1,"rope",3,13.8112460574566
3.40240634885896,1,5.45009913566502,2,14.8485234725918,3,1,"rope",2,11.4461171237328
4.08462214936782,1,5.45009913566502,2,14.8485234725918,3,1,"rope",2,10.763901323224
4.26906885859836,1,5.45009913566502,2,21.9458433861568,8,1,"rope",7,17.6767745275584
7.2063983369922,1,27.4139051215612,5,35.348390416272,5,1,"rope",4,28.1419920792798
7.22959123197224,1,27.4139051215612,5,38.8900989322108,6,1,"rope",5,31.6605077002386
7.84090979275506,1,27.4139051215612,5,35.348390416272,5,1,"rope",4,27.5074806235169
9.3275152673964,1,27.4139051215612,5,41.6416113530923,8,1,"rope",7,32.3140960856959
1.21193384654344,2,2.22593408719548,1,12.5533736378505,9,1,"rope",7,11.3414397913071
2.74024267761473,2,12.8160480990318,2,21.1155350743679,7,1,"rope",5,18.3752923967532
2.9216130822487,2,12.8160480990318,2,21.9458433861568,8,1,"rope",6,19.0242303039081
3.60282163690402,2,12.8160480990318,2,18.3951437886225,5,1,"rope",3,14.7923221517185
3.62657608041166,2,12.8160480990318,2,18.3951437886225,5,1,"rope",3,14.7685677082108
6.04811973524561,2,20.7262858991525,4,36.271420286189,10,1,"rope",8,30.2233005509434
6.37912453691756,2,20.7262858991525,4,35.7059073914198,9,1,"rope",7,29.3267828545022
9.89339319187171,2,20.7262858991525,4,30.3241446799387,7,1,"rope",5,20.430751488067
10.0958721231572,2,20.7262858991525,4,30.3241446799387,7,1,"rope",5,20.2282725567815
12.4259609824551,2,20.7262858991525,4,30.3241446799387,7,1,"rope",5,17.8981836974836
1.26099484130265,3,2.71741797019484,1,12.5533736378505,9,1,"rope",6,11.2923787965479
3.83467681596016,3,32.0177002306523,5,42.1736354242796,9,1,"rope",6,38.3389586083194
5.6789152275113,3,32.0177002306523,5,41.6416113530923,8,1,"rope",5,35.962696125581
6.45271480582847,3,32.0177002306523,5,42.1736354242796,9,1,"rope",6,35.7209206184511
8.12325706451372,3,32.0177002306523,5,35.348390416272,5,1,"rope",2,27.2251333517583
10.5424884824944,3,46.4826870001149,2,60.6364343228473,10,1,"rope",7,50.0939458403529
12.5238746484763,3,46.4826870001149,2,60.6364343228473,10,1,"rope",7,48.112559674371
14.4101190460027,3,34.8282207296429,2,36.7879424371282,1,1,"rope",2,22.3778233911255
15.7243826328469,3,46.4826870001149,2,57.1642893411951,8,1,"rope",5,41.4399067083482
17.9713709795211,3,46.4826870001149,2,55.7479150617989,7,1,"rope",4,37.7765440822778
2.81250933198145,4,3.68015164314749,4,7.36970969907535,2,1,"rope",2,4.5572003670939
3.16757911740167,4,4.69735850769092,1,16.5765483850415,10,1,"rope",6,13.4089692676398
7.00359502096302,4,32.6671703637539,5,38.8900989322108,6,1,"rope",2,31.8865039112478
2.72098895769223,5,6.748634293022,1,16.5765483850415,10,1,"rope",5,13.8555594273493
6.58501237913279,5,18.3951437886225,2,21.9458433861568,8,1,"rope",3,15.360831007024
8.61404262455114,5,32.6550459822238,2,34.8282207296429,3,1,"rope",2,26.2141781050918
0.665127624653799,6,7.39790157978669,5,10.1673279469733,4,1,"rope",2,9.5022003223195
1.91221619076582,6,3.70370875849369,3,20.202092011905,10,1,"rope",4,18.2898758211392
2.5316831567839,6,7.39790157978669,5,16.5828489657465,1,1,"rope",5,14.0511658089626
0.316811569809752,7,13.3969238774396,3,18.2184603966734,9,1,"rope",2,17.9016488268636
2.66585368912804,7,13.3969238774396,3,18.2184603966734,9,1,"rope",2,15.5526067075454
4.05158006891188,7,6.90894010813578,5,15.5760286799136,2,1,"rope",5,11.5244486110017
4.7186806919357,8,22.2202865743799,1,31.1655507339257,5,1,"rope",3,26.44687004199
7.03343125328632,8,11.0813055376031,1,16.5765483850415,10,1,"rope",2,9.54311713175518
13.8848900011879,8,22.2202865743799,1,34.6369480420178,4,1,"rope",4,20.7520580408299
0.244842185901609,9,2.30117324946218,5,16.5828489657465,1,1,"rope",8,16.3380067798449
0.638335428152986,9,2.30117324946218,5,12.8729678601157,3,1,"rope",6,12.2346324319627
3.98319924976678,9,21.5888684708899,1,37.6993580085442,1,1,"rope",8,33.7161587587774
0.31137562977771,10,1,5,3.8817152047501,8,1,"rope",2,3.57033957497239
4.14938725517098,10,19.9075273271452,1,34.6369480420178,4,1,"rope",6,30.4875607868468
9.18419347143612,10,19.9075273271452,1,34.6369480420178,4,1,"rope",6,25.4527545705817
2.14749728997561,1,6.9953569888257,2,34.1937031103709,9,1,"chain",8,32.0462058203953
2.87403698371027,1,6.9953569888257,2,21.0711627084191,4,1,"chain",3,18.1971257247088
3.47533178295244,1,6.9953569888257,2,36.9857129758264,10,1,"chain",9,33.510381192874
4.65072648316799,1,6.9953569888257,2,17.9002319548224,3,1,"chain",2,13.2495054716544
4.68152030041619,1,6.9953569888257,2,23.4250470825356,5,1,"chain",4,18.7435267821194
6.31674034741865,1,12.5243524771611,4,16.9371414028053,3,1,"chain",2,10.6204010553866
6.39328113232897,1,12.5243524771611,4,26.6934891394407,6,1,"chain",5,20.3002080071117
7.27951603599506,1,12.5243524771611,4,19.0954168840183,4,1,"chain",3,11.8159008480232
7.50063734911159,1,12.5243524771611,4,30.5634455792856,8,1,"chain",7,23.062808230174
9.04713106929082,1,12.5243524771611,4,19.0954168840183,4,1,"chain",3,10.0482858147275
1.636411935007,2,3.91735906509643,1,12.0534999457022,6,1,"chain",4,10.4170880106952
1.83941006558927,2,3.91735906509643,1,32.7769219357494,10,1,"chain",8,30.9375118701601
1.96955711665543,2,3.91735906509643,1,29.4157536795932,9,1,"chain",7,27.4461965629378
2.77087899005476,2,3.91735906509643,1,12.0534999457022,6,1,"chain",4,9.28262095564744
3.49106151314412,2,29.6741286347751,5,43.7453823421163,8,1,"chain",6,40.2543208289722
4.33332820774667,2,29.6741286347751,5,37.4501514258948,5,1,"chain",3,33.1168232181481
4.47075368303485,2,29.6741286347751,5,43.7453823421163,8,1,"chain",6,39.2746286590815
5.29817586041191,2,29.6741286347751,5,35.3820220100075,4,1,"chain",2,30.0838461495956
5.31388670087927,2,29.6741286347751,5,42.1073449332602,7,1,"chain",5,36.7934582323809
7.09242455348488,2,29.6741286347751,5,37.4501514258948,5,1,"chain",3,30.3577268724099
1.44788782112507,3,4.97115982565382,1,12.0534999457022,6,1,"chain",3,10.6056121245771
2.07857733359767,3,4.97115982565382,1,11.0015331709592,5,1,"chain",2,8.92295583736153
3.05625198544666,3,4.97115982565382,1,11.0015331709592,5,1,"chain",2,7.94528118551254
3.81496168299613,3,4.97115982565382,1,29.4157536795932,9,1,"chain",6,25.6007919965971
3.82441120742788,3,63.0595790811514,3,78.5552771377344,10,1,"chain",7,74.7308659303065
4.04600457250108,3,12.6224807764695,5,21.1110808248799,1,1,"chain",2,17.0650762523788
4.65022809951534,3,63.0595790811514,3,78.5552771377344,10,1,"chain",7,73.905049038219
4.69013947210242,3,12.6224807764695,5,21.1110808248799,1,1,"chain",2,16.4209413527775
4.72508413599786,3,63.0595790811514,3,71.5403022500316,7,1,"chain",4,66.8152181140337
6.44374508657454,3,63.0595790811514,3,75.7411174641098,9,1,"chain",6,69.2973723775353
0.351469358429313,4,19.0954168840183,4,33.034018280147,9,1,"chain",5,32.6825489217177
1.07151046705743,4,19.0954168840183,4,26.6934891394407,6,1,"chain",2,25.6219786723833
14.8056411456766,4,19.0954168840183,4,33.034018280147,9,1,"chain",5,18.2283771344704
2.96971453379192,5,23.4250470825356,2,28.9876667709249,7,1,"chain",2,26.017952237133
11.7858105275364,5,23.4250470825356,2,36.9857129758264,10,1,"chain",5,25.19990244829
13.1839904979076,5,23.4250470825356,2,30.5634455792856,8,1,"chain",3,17.379455081378
0.650893258862197,6,9.37372633597955,5,12.8578040775491,2,1,"chain",4,12.2069108186869
3.37598182244175,6,9.37372633597955,5,12.8578040775491,2,1,"chain",4,9.48182225510735
4.21036088356697,6,9.62781945565596,3,21.6709701451052,8,1,"chain",2,17.4606092615382
3.29561423555604,7,7.24245325120289,5,12.8578040775491,2,1,"chain",5,9.56218984199306
9.39276805785695,7,49.680481854954,4,58.3640733390302,5,1,"chain",2,48.9713052811733
11.541611656409,7,49.680481854954,4,63.1817817394685,4,1,"chain",3,51.6401700830595
1.9632137613371,8,21.6709701451052,3,21.8567558781032,10,1,"chain",2,19.8935421167661
13.8118846195268,8,45.5725731415873,4,72.8695414281276,2,1,"chain",6,59.0576568086008
17.922161129084,8,45.5725731415873,4,72.8695414281276,2,1,"chain",6,54.9473802990436
1.62475671552335,9,30.7738856370574,3,38.5445089745857,6,1,"chain",3,36.9197522590624
2.09343120863605,9,30.7738856370574,3,48.5173664463366,2,1,"chain",7,46.4239352377006
5.89509822511646,9,30.7738856370574,3,38.5445089745857,6,1,"chain",3,32.6494107494692
4.55865971419617,10,28.101422000158,3,48.5173664463366,2,1,"chain",8,43.9587067321404
16.7965450441711,10,28.101422000158,3,33.4183684797131,8,1,"chain",2,16.621823435542
21.277440661387,10,28.101422000158,3,49.2100483709848,1,1,"chain",9,27.9326077095978
1.83584305821898,1,13.5498443840955,2,34.0420376403605,5,1,"chain",4,32.2061945821415
2.23668390371594,1,13.5498443840955,2,29.3719262926367,4,1,"chain",3,27.1352423889208
2.50628818710092,1,13.5498443840955,2,29.3719262926367,4,1,"chain",3,26.8656381055358
5.42518728348144,1,13.5498443840955,2,24.9706761008368,3,1,"chain",2,19.5454888173554
7.07062484251032,1,13.5498443840955,2,29.3719262926367,4,1,"chain",3,22.3013014501264
7.77921057259686,1,13.5498443840955,2,29.3719262926367,4,1,"chain",3,21.5927157200398
8.255693593994,1,13.5498443840955,2,24.9706761008368,3,1,"chain",2,16.7149825068428
8.26057435803823,1,13.5498443840955,2,50.8092347460122,10,1,"chain",9,42.548660387974
10.6050061922076,1,13.5498443840955,2,29.3719262926367,4,1,"chain",3,18.7669201004291
12.3843671793696,1,13.5498443840955,2,42.6645376958119,8,1,"chain",7,30.2801705164423
2.99709462357645,2,22.6321809434631,4,42.6645376958119,8,1,"chain",6,39.6674430722355
3.07521490683738,2,22.6321809434631,4,41.7081911456006,7,1,"chain",5,38.6329762387632
5.19587766483821,2,22.6321809434631,4,29.3719262926367,4,1,"chain",2,24.1760486277985
5.21403265464187,2,22.6321809434631,4,50.8092347460122,10,1,"chain",8,45.5952020913703
5.85598322887972,2,22.6321809434631,4,34.0420376403605,5,1,"chain",3,28.1860544114808
5.9896662546165,2,22.6321809434631,4,42.6645376958119,8,1,"chain",6,36.6748714411954
6.37501845404801,2,22.6321809434631,4,41.7081911456006,7,1,"chain",5,35.3331726915526
9.84232273386571,2,22.6321809434631,4,50.8092347460122,10,1,"chain",8,40.9669120121465
11.3351164026411,2,22.6321809434631,4,45.6968603929937,9,1,"chain",7,34.3617439903526
12.04360525811,2,22.6321809434631,4,37.4537634736079,6,1,"chain",4,25.4101582154979
0.45826866918947,3,8.02659536457638,4,16.673381607468,1,1,"chain",2,16.2151129382785
1.3521897259098,3,3.86065670839491,1,22.8335297190737,10,1,"chain",7,21.4813399931639
1.76501678507072,3,3.86065670839491,1,14.5831310735686,8,1,"chain",5,12.8181142884979
2.35262277926546,3,3.86065670839491,1,21.6542812964799,9,1,"chain",6,19.3016585172144
3.27469560797079,3,25.7767483795305,5,45.0594078568999,9,1,"chain",6,41.7847122489291
3.98921188069715,3,25.7767483795305,5,42.6645376958119,8,1,"chain",5,38.6753258151148
4.70974147045717,3,25.7767483795305,5,35.6541147851824,6,1,"chain",3,30.9443733147252
4.74558691546053,3,8.02659536457638,4,16.673381607468,1,1,"chain",2,11.9277946920075
7.00445362592284,3,8.02659536457638,4,16.673381607468,1,1,"chain",2,9.66892798154516
8.41024262488968,3,25.7767483795305,5,45.0594078568999,9,1,"chain",6,36.6491652320102
0.718671965054169,4,5.68855358303868,1,14.5831310735686,8,1,"chain",4,13.8644591085144
3.75935909009033,4,5.68855358303868,1,8.06858932961942,6,1,"chain",2,4.30923023952909
6.24309133175117,4,29.3719262926367,5,41.7081911456006,7,1,"chain",3,35.4650998138494
5.65908128395801,5,34.0420376403605,2,41.9234329679165,7,1,"chain",2,36.2643516839585
10.4489763815603,5,15.4331580650271,5,18.3389373455935,3,1,"chain",2,7.8899609640332
13.7990753117581,5,34.0420376403605,2,50.8092347460122,10,1,"chain",5,37.0101594342541
4.74331281761407,6,11.8996954260887,5,18.3389373455935,3,1,"chain",3,13.5956245279794
4.75194986436595,6,5.61316798229642,3,18.13474307384,9,1,"chain",3,13.382793209474
6.62732347621488,6,11.8996954260887,5,17.623052379586,4,1,"chain",2,10.9957289033711
0.00949687134416117,7,7.80775001130015,5,23.2392996015948,1,1,"chain",6,23.2298027302506
11.3688572875143,7,45.8802301424514,3,60.760206411873,1,1,"chain",6,49.3913491243587
18.1565228977463,7,41.7081911456006,5,45.0594078568999,9,1,"chain",2,26.9028849591536
13.0338600457164,8,14.5831310735686,3,21.4992221995754,10,1,"chain",2,8.465362153859
14.1319944810535,8,42.6645376958119,5,50.8092347460122,10,1,"chain",2,36.6772402649587
14.6984951081788,8,44.1837301316916,1,50.2763124575139,6,1,"chain",2,35.5778173493351
0.238660086567203,9,1.94348081708046,5,18.3389373455935,3,1,"chain",6,18.1002772590263
1.97676601974914,9,40.215383696283,3,50.2763124575139,6,1,"chain",3,48.2995464377648
10.204662118747,9,40.215383696283,3,45.8802301424514,7,1,"chain",2,35.6755680237044
3.86708438410784,10,28.6140988969064,3,54.3135868284356,5,1,"chain",5,50.4465024443278
9.9302240646008,10,28.6140988969064,3,50.2763124575139,6,1,"chain",4,40.3460883929131
10.1300622304155,10,28.6140988969064,3,45.8802301424514,7,1,"chain",3,35.7501679120359
0.171612387980027,1,1,1,13.2420059999134,7,1,"chain",6,13.0703936119334
0.755443096617861,1,1,1,17.1418143971936,10,1,"chain",9,16.3863713005757
1.88134161145013,1,8.35199199761164,2,42.0548813011557,10,1,"chain",9,40.1735396897056
2.07284666453075,1,8.35199199761164,2,42.0548813011557,10,1,"chain",9,39.982034636625
2.31211108622068,1,8.35199199761164,2,40.1968174100123,9,1,"chain",8,37.8847063237916
3.21605141643817,1,8.35199199761164,2,14.7302645671292,3,1,"chain",2,11.514213150691
4.01562124296929,1,8.35199199761164,2,27.4986643259597,5,1,"chain",4,23.4830430829904
4.57567267531435,1,8.35199199761164,2,31.5988417723893,7,1,"chain",6,27.0231690970749
5.46071164201085,1,8.35199199761164,2,42.0548813011557,10,1,"chain",9,36.5941696591449
5.48821430311609,1,8.35199199761164,2,24.2706614967807,4,1,"chain",3,18.7824471936646
3.328243329953,2,15.1160559741132,4,27.4986643259597,5,1,"chain",3,24.1704209960067
3.54380452988629,2,15.1160559741132,4,35.0719949859441,9,1,"chain",7,31.5281904560578
3.61947035803219,2,15.1160559741132,4,35.0719949859441,9,1,"chain",7,31.4525246279119
4.72021709392062,2,15.1160559741132,4,24.2706614967807,4,1,"chain",2,19.5504444028601
6.35176711903148,2,15.1160559741132,4,30.4881368830833,7,1,"chain",5,24.1363697640518
9.49091028386021,2,15.1160559741132,4,24.2706614967807,4,1,"chain",2,14.7797512129205
9.89220070383737,2,15.1160559741132,4,36.9502106966498,10,1,"chain",8,27.0580099928124
11.616018050132,2,15.1160559741132,4,36.9502106966498,10,1,"chain",8,25.3341926465178
12.903644419015,2,15.1160559741132,4,35.0719949859441,9,1,"chain",7,22.1683505669291
14.147691321257,2,15.1160559741132,4,31.3754681858064,8,1,"chain",6,17.2277768645494
0.195436133519971,3,7.88841582257305,4,12.5607345462989,1,1,"chain",2,12.3652984127789
0.317873865814173,3,2.36338380807983,1,13.2420059999134,7,1,"chain",4,12.9241321340992
2.40666633690327,3,31.8570790368226,5,46.8867494054801,6,1,"chain",3,44.4800830685768
2.62349325404123,3,31.8570790368226,5,51.1539634387769,8,1,"chain",5,48.5304701847357
2.68581360519652,3,31.8570790368226,5,44.4416085591348,5,1,"chain",2,41.7557949539383
3.60256056424475,3,31.8570790368226,5,53.4232620342471,9,1,"chain",6,49.8207014700024
4.19488554571068,3,31.8570790368226,5,48.0943473267338,7,1,"chain",4,43.8994617810231
5.23207696691761,3,31.8570790368226,5,44.4416085591348,5,1,"chain",2,39.2095315922172
7.26005513935936,3,31.8570790368226,5,54.2987733872143,10,1,"chain",7,47.0387182478549
8.12546186957119,3,31.8570790368226,5,53.4232620342471,9,1,"chain",6,45.2978001646759
1.05470105074346,4,5.78205852864081,1,15.8462822419516,9,1,"chain",5,14.7915811912081
2.58130310517895,4,5.78205852864081,1,15.5149560752099,8,1,"chain",4,12.933652970031
3.75309606031674,4,19.9105540973591,5,24.389841537619,1,1,"chain",3,20.6367454773023
0.517372296502193,5,1,3,9.18356099170426,8,1,"chain",3,8.66618869520207
2.85548655754492,5,49.5848720057155,3,53.0107872452538,8,1,"chain",3,50.1553006877089
8.1725342085302,5,31.5385844220901,3,37.5409685759175,3,1,"chain",2,29.3684343673873
0.349919406049791,6,11.3400368268505,5,22.1361806214869,3,1,"chain",3,21.7862612154371
6.67772000749054,6,11.3400368268505,5,19.9105540973591,4,1,"chain",2,13.2328340898686
9.65119254233983,6,50.1473241429063,3,62.9007771564158,9,1,"chain",3,53.249584614076
0.929028508253396,7,4.26629634235839,3,17.1418143971936,10,1,"chain",3,16.2127858889402
3.82619095657762,7,7.37337908629218,5,19.9105540973591,4,1,"chain",3,16.0843631407815
6.09050743594265,7,7.37337908629218,5,16.3198249353565,5,1,"chain",2,10.2293174994139
2.89617654232585,8,5.24539823578357,5,24.389841537619,1,1,"chain",7,21.4936649952931
5.02604293933415,8,29.7748493680577,1,32.9443700482182,6,1,"chain",2,27.918327108884
5.36509383425985,8,29.7748493680577,1,38.1238648965908,5,1,"chain",3,32.758771062331
6.73003302238194,9,27.1282198201329,3,37.5409685759175,3,1,"chain",6,30.8109355535356
7.4955024194897,9,27.1282198201329,3,41.3256670298461,1,1,"chain",8,33.8301646103564
8.77001378346789,9,27.1282198201329,3,30.9881738744523,6,1,"chain",3,22.2181600909844
9.95538325391647,10,20.7282417699899,3,30.1971607839536,7,1,"chain",3,20.2417775300371
11.4037011955051,10,20.7282417699899,3,39.0470099225438,2,1,"chain",8,27.6433087270387
13.6231814079725,10,20.7282417699899,3,30.1971607839536,7,1,"chain",3,16.5739793759811
0.0515322666615248,1,1,1,8.30280347354796,4,1,"chain",3,8.25127120688644
0.94718335564704,1,1,1,19.3748404422481,10,1,"chain",9,18.4276570866011
1.40254518944294,1,12.2950560043627,4,18.0284846084527,3,1,"chain",2,16.6259394190098
1.76629753918843,1,12.2950560043627,4,18.0284846084527,3,1,"chain",2,16.2621870692643
2.15360204778136,1,12.2950560043627,4,27.0807285391943,9,1,"chain",8,24.9271264914129
3.09046796980294,1,12.2950560043627,4,22.5291529819104,7,1,"chain",6,19.4386850121075
3.44290335561129,1,12.2950560043627,4,27.0807285391943,9,1,"chain",8,23.637825183583
4.9234383709911,1,12.2950560043627,4,28.6341852176919,10,1,"chain",9,23.7107468467008
4.93977203968879,1,12.2950560043627,4,18.9555895793594,5,1,"chain",4,14.0158175396706
5.74907960742203,1,12.2950560043627,4,21.563327642364,6,1,"chain",5,15.814248034942
0.559543574694544,2,4.73607231384016,1,12.8234189815331,6,1,"chain",4,12.2638754068386
1.55711846561627,2,4.73607231384016,1,12.8234189815331,6,1,"chain",4,11.2663005159168
3.1496804965331,2,4.73607231384016,1,15.410174887519,8,1,"chain",6,12.2604943909859
3.51465826143015,2,4.73607231384016,1,8.30280347354796,4,1,"chain",2,4.78814521211781
4.47787742638866,2,16.9335627643726,2,24.3972501937527,5,1,"chain",3,19.919372767364
4.87148388486405,2,16.9335627643726,2,28.7171208143706,7,1,"chain",5,23.8456369295065
5.22277907572736,2,16.9335627643726,2,19.3157359699924,4,1,"chain",2,14.092956894265
6.84560013258904,2,16.9335627643726,2,24.3972501937527,5,1,"chain",3,17.5516500611637
7.1472621566996,2,16.9335627643726,2,27.5161482556789,6,1,"chain",4,20.3688860989793
7.37341413296834,2,16.9335627643726,2,19.3157359699924,4,1,"chain",2,11.9423218370241
0.802320949113889,3,26.1483027942713,5,51.8023022152231,10,1,"chain",7,50.9999812661092
1.12812782343008,3,26.1483027942713,5,44.9970747090856,8,1,"chain",5,43.8689468856555
3.81240214472603,3,26.1483027942713,5,51.8023022152231,10,1,"chain",7,47.9899000704971
4.82546655303946,3,26.1483027942713,5,33.044894437295,5,1,"chain",2,28.2194278842555
5.679237876155,3,26.1483027942713,5,46.3749564686264,9,1,"chain",6,40.6957185924714
6.18034130807272,3,26.1483027942713,5,46.3749564686264,9,1,"chain",6,40.1946151605537
6.64199263143591,3,26.1483027942713,5,33.044894437295,5,1,"chain",2,26.4029018058591
7.16094893316976,3,26.1483027942713,5,41.849201089496,7,1,"chain",4,34.6882521563262
7.75420627717972,3,19.092052892858,5,21.4972040327867,1,1,"chain",2,13.742997755607
9.54055945169273,3,26.1483027942713,5,39.8233154404217,6,1,"chain",3,30.282755988729
6.3043919575394,4,15.2382336926211,5,20.7882065408785,2,1,"chain",2,14.4838145833391
8.83895456128033,4,15.2382336926211,5,20.7882065408785,2,1,"chain",2,11.9492519795982
8.85343964169634,4,45.5778520441591,3,47.7945261569839,7,1,"chain",3,38.9410865152876
4.2524247553041,5,10.2377960430558,1,15.410174887519,8,1,"chain",3,11.1577501322149
10.3334515160189,5,14.6534449198936,5,19.092052892858,3,1,"chain",2,8.7586013768391
18.6211509678897,5,34.2848301142778,3,39.2638461489737,2,1,"chain",3,20.642695181084
1.12342607385168,6,10.3149933253248,5,15.2382336926211,4,1,"chain",2,14.1148076187694
9.60176066298249,6,12.8234189815331,1,19.3748404422481,10,1,"chain",4,9.77307977926561
9.98857233010443,6,12.8234189815331,1,18.1199323005913,9,1,"chain",3,8.13135997048687
1.53395009847979,7,8.40061389317019,5,14.6534449198936,5,1,"chain",2,13.1194948214138
2.28359055860589,7,22.5291529819104,4,27.0807285391943,9,1,"chain",2,24.7971379805884
2.82785562491801,7,8.40061389317019,5,15.2382336926211,4,1,"chain",3,12.4103780677031
4.52346056996191,8,25.9406199672546,1,46.7942333552366,1,1,"chain",7,42.2707727852747
18.5033117767257,8,25.9406199672546,1,37.3687444136893,3,1,"chain",5,18.8654326369636
19.1274800202954,8,25.9406199672546,1,33.32216607594,6,1,"chain",2,14.1946860556446
6.37422881992467,9,15.5836629370261,3,41.4766944453157,1,1,"chain",8,35.102465625391
9.15598987870129,9,15.5836629370261,3,29.7812208219258,7,1,"chain",2,20.6252309432245
10.4062107014925,9,15.5836629370261,3,39.2638461489737,2,1,"chain",7,28.8576354474812
5.07721372372323,10,14.1480033549044,3,39.2638461489737,2,1,"chain",8,34.1866324252505
6.18210512481793,10,14.1480033549044,3,39.2638461489737,2,1,"chain",8,33.0817410241558
7.05576224831406,10,14.1480033549044,3,33.32216607594,6,1,"chain",4,26.2664038276259
0.180089667905122,1,1,1,16.6765991203862,5,1,"chain",4,16.4965094524811
0.616007359698415,1,1,1,21.1007732153047,10,1,"chain",9,20.4847658556063
1.46244296893002,1,5.10396524688189,2,14.0020607230968,4,1,"chain",3,12.5396177541668
3.06433190858427,1,5.10396524688189,2,20.336176039677,9,1,"chain",8,17.2718441310927
5.74454026550926,1,24.5063149688515,5,41.7887337022723,8,1,"chain",7,36.044193436763
6.58786588970968,1,24.5063149688515,5,30.1110328297071,4,1,"chain",3,23.5231669399974
7.0556232097412,1,24.5063149688515,5,28.2636430625882,3,1,"chain",2,21.208019852847
7.36275800940045,1,24.5063149688515,5,39.9862901065719,7,1,"chain",6,32.6235320971714
8.22252080649058,1,24.5063149688515,5,39.9862901065719,7,1,"chain",6,31.7637693000813
8.9618675221841,1,24.5063149688515,5,28.2636430625882,3,1,"chain",2,19.3017755404041
0.661172579042614,2,3.63899049560464,1,14.6775118713142,4,1,"chain",2,14.0163392922716
1.07103205891326,2,3.63899049560464,1,18.6161155152588,7,1,"chain",5,17.5450834563455
1.30857355939224,2,3.63899049560464,1,14.6775118713142,4,1,"chain",2,13.368938311922
2.31603886757812,2,3.63899049560464,1,14.6775118713142,4,1,"chain",2,12.3614730037361
7.46507097018182,2,10.7565292769357,2,18.2587598973214,7,1,"chain",5,10.7936889271396
8.1784852830854,2,10.7565292769357,2,18.2587598973214,7,1,"chain",5,10.080274614236
8.26460503685966,2,10.7565292769357,2,14.9786206225921,5,1,"chain",3,6.71401558573244
12.5324129561397,2,27.8033317608974,4,32.6561939907475,5,1,"chain",3,20.1237810346078
13.1426188220704,2,27.8033317608974,4,44.66514594864,8,1,"chain",6,31.5225271265696
15.3678767867492,2,27.8033317608974,4,31.2798808320402,4,1,"chain",2,15.912004045291
0.933698552517176,3,28.618998025612,4,47.4730156347708,10,1,"chain",7,46.5393170822536
1.37036297921646,3,28.618998025612,4,45.1480354498136,9,1,"chain",6,43.7776724705971
2.33775704149236,3,9.32598277125795,4,12.5974449055389,1,1,"chain",2,10.2596878640465
2.7514827448856,3,28.618998025612,4,39.7285397118178,6,1,"chain",3,36.9770569669322
3.43576893973909,3,9.32598277125795,4,12.5974449055389,1,1,"chain",2,9.16167596579981
4.12612933870218,3,28.618998025612,4,41.5887552683839,7,1,"chain",4,37.4626259296817
5.376932469339,3,28.618998025612,4,47.4730156347708,10,1,"chain",7,42.0960831654318
6.87000959131356,3,28.618998025612,4,47.4730156347708,10,1,"chain",7,40.6030060434572
8.09027288894114,3,28.618998025612,4,47.4730156347708,10,1,"chain",7,39.3827427458297
10.7417523323503,3,38.2829006127524,3,42.8484694675887,1,1,"chain",2,32.1067171352384
0.760007561323371,4,14.6775118713142,1,18.6161155152588,7,1,"chain",3,17.8561079539354
7.25711783845763,4,14.6775118713142,1,20.2500821498424,8,1,"chain",4,12.9929643113848
7.6806652761826,4,58.8721140686462,5,75.69665186787,1,1,"chain",3,68.0159865916874
7.71985933262758,5,34.1951268046206,3,39.0171317706578,2,1,"chain",3,31.2972724380302
7.99875602514696,5,34.1951268046206,3,42.8484694675887,1,1,"chain",4,34.8497134424417
14.6127808688875,5,31.6532446605657,5,42.161716245831,9,1,"chain",4,27.5489353769435
2.07442046453555,6,10.3165246347219,5,14.9074569067564,3,1,"chain",3,12.8330364422209
2.81126589048654,6,7.41189926829109,3,17.064975740483,10,1,"chain",4,14.2537098499965
2.94045544451192,6,10.3165246347219,5,16.9219748743694,2,1,"chain",4,13.9815194298575
4.73666337601153,7,14.0808710722882,3,16.2416047281837,9,1,"chain",2,11.5049413521722
4.95010171497689,7,14.0808710722882,3,17.064975740483,10,1,"chain",3,12.1148740255061
15.788301121279,7,30.4724351880321,3,37.5572003523578,4,1,"chain",3,21.7688992310788
0.134431090071978,8,8.62296906546877,5,13.8979635465303,4,1,"chain",4,13.7635324564583
5.49490823431141,8,8.62296906546877,5,19.3139058620879,1,1,"chain",7,13.8189976277765
6.07675529105789,8,8.62296906546877,5,19.3139058620879,1,1,"chain",7,13.23715057103
0.516398381482273,9,5.73759591797185,5,9.68499549441227,7,1,"chain",2,9.16859711293
8.97296030036393,9,23.8847144845532,3,42.8484694675887,1,1,"chain",8,33.8755091672248
16.6812860150585,9,23.8847144845532,3,34.1951268046206,5,1,"chain",4,17.5138407895621
0.951421375696858,10,1,5,19.3139058620879,1,1,"chain",9,18.362484486391
1.5299207599296,10,21.93532189347,3,38.2829006127524,3,1,"chain",7,36.7529798528228
8.80843234244805,10,21.93532189347,3,29.7725121504094,8,1,"chain",2,20.9640798079614
1.79836632675471,1,9.29744058441291,2,21.6055282633601,6,1,"chain",5,19.8071619366054
1.93794936259257,1,9.29744058441291,2,16.0435501094376,4,1,"chain",3,14.105600746845
3.05877376940537,1,9.29744058441291,2,21.6055282633601,6,1,"chain",5,18.5467544939547
3.63727554500065,1,9.29744058441291,2,14.4379180516982,3,1,"chain",2,10.8006425066975
6.79022807591547,1,9.29744058441291,2,23.7434595098142,7,1,"chain",6,16.9532314338987
6.89696370447938,1,9.29744058441291,2,19.3098492814067,5,1,"chain",4,12.4128855769273
7.45267967474391,1,9.29744058441291,2,37.887620359022,9,1,"chain",8,30.4349406842781
9.49050659645073,1,18.0949818903667,4,38.2860965672764,10,1,"chain",9,28.7955899708257
12.197035202218,1,18.0949818903667,4,34.4547783321918,8,1,"chain",7,22.2577431299738
12.9803108474022,1,18.0949818903667,4,26.9642390442778,4,1,"chain",3,13.9839281968756
0.268884005650868,2,2.67996180391871,1,7.02130902486176,4,1,"chain",2,6.75242501921089
0.292083210937669,2,2.67996180391871,1,10.8660724792589,6,1,"chain",4,10.5739892683212
1.60772994777829,2,2.67996180391871,1,14.6717787877122,9,1,"chain",7,13.0640488399339
1.850394922011,2,2.67996180391871,1,13.6561375559004,8,1,"chain",6,11.8057426338894
4.33768879672988,2,21.3406724053704,4,27.7502892760077,5,1,"chain",3,23.4126004792778
4.38352806542933,2,21.3406724053704,4,38.2860965672764,10,1,"chain",8,33.9025685018471
4.48306131831303,2,21.3406724053704,4,34.4547783321918,8,1,"chain",6,29.9717170138788
5.60672564430551,2,21.3406724053704,4,38.2860965672764,10,1,"chain",8,32.6793709229709
7.17921514612991,2,21.3406724053704,4,31.7524722879046,7,1,"chain",5,24.5732571417747
10.413262171404,2,21.3406724053704,4,31.7524722879046,7,1,"chain",5,21.3392101165006
0.0243922207706549,3,3.6683551553078,1,16.6170669726584,10,1,"chain",7,16.5926747518877
0.775134981215546,3,3.6683551553078,1,14.6717787877122,9,1,"chain",6,13.8966438064967
1.18482292124684,3,3.6683551553078,1,10.8660724792589,6,1,"chain",3,9.68124955801206
1.62757828244009,3,3.6683551553078,1,16.6170669726584,10,1,"chain",7,14.9894886902183
5.96966242884396,3,6.76921561335154,4,15.6381235907401,1,1,"chain",2,9.66846116189614
6.92990387693614,3,37.9822591079327,5,55.8414507496936,10,1,"chain",7,48.9115468727575
6.98020621153161,3,37.9822591079327,5,51.8389601807927,9,1,"chain",6,44.8587539692611
8.12456340754495,3,37.9822591079327,5,48.2558752207899,7,1,"chain",4,40.1313118132449
8.81684471566321,3,37.9822591079327,5,45.4009786403144,6,1,"chain",3,36.5841339246512
9.04524096271865,3,37.9822591079327,5,55.8414507496936,10,1,"chain",7,46.7962097869749
12.3478378534766,4,26.3239952143566,3,32.1299615098084,1,1,"chain",3,19.7821236563318
12.7916968653428,4,41.2043762291215,3,51.0688034215664,8,1,"chain",4,38.2771065562236
12.9115674383266,4,26.3239952143566,3,32.1299615098084,1,1,"chain",3,19.2183940714818
2.2773126900817,5,44.3170269974205,3,55.8414507496936,10,1,"chain",5,53.5641380596119
3.20814013636361,5,18.8341460978658,5,31.031989123975,1,1,"chain",4,27.8238489876114
4.89515771974846,5,18.8341460978658,5,31.031989123975,1,1,"chain",4,26.1368314042265
11.5241521342955,6,21.6055282633601,2,40.5295869607465,10,1,"chain",4,29.005434826451
11.6100817873187,6,26.5756932647838,1,31.1651543704449,3,1,"chain",3,19.5550725831262
16.0865040014384,6,21.6055282633601,2,37.887620359022,9,1,"chain",3,21.8011163575836
0.484965266674344,7,19.4484471261388,3,32.1299615098084,1,1,"chain",6,31.6449962431341
13.6025000015247,7,19.4484471261388,3,29.6247772914355,2,1,"chain",5,16.0222772899108
14.8001739453497,7,19.4484471261388,3,26.3239952143566,4,1,"chain",3,11.5238212690069
0.963834947906435,8,13.5656767931509,5,18.8341460978658,5,1,"chain",3,17.8703111499594
3.16773113484184,8,13.5656767931509,5,18.8341460978658,5,1,"chain",3,15.666414963024
8.26227938728341,8,13.5656767931509,5,26.795718120812,3,1,"chain",5,18.5334387335286
0.211414285370696,9,5.97709285835601,5,17.4549835625847,6,1,"chain",3,17.243569277214
4.16259247211419,9,5.97709285835601,5,26.795718120812,3,1,"chain",6,22.6331256486978
4.63060571284414,9,5.97709285835601,5,27.6630938800336,2,1,"chain",7,23.0324881671895
2.19506576657295,10,13.527772933596,3,22.3872277316153,5,1,"chain",5,20.1921619650424
8.95085521014341,10,13.527772933596,3,19.4484471261388,7,1,"chain",3,10.4975919159954
9.13645786826122,10,13.527772933596,3,29.6247772914355,2,1,"chain",8,20.4883194231743
0.0208727720045279,1,1,1,4.6473836052893,4,1,"chain",3,4.62651083328477
3.02973242858765,1,11.8861950834885,4,20.7071837804446,5,1,"chain",4,17.6774513518569
4.48498878256738,1,11.8861950834885,4,31.6348771436233,7,1,"chain",6,27.1498883610559
4.60525104317539,1,11.8861950834885,4,20.7071837804446,5,1,"chain",4,16.1019327372692
4.63863584918627,1,11.8861950834885,4,31.6348771436233,7,1,"chain",6,26.996241294437
5.1366751469458,1,11.8861950834885,4,17.4275572876051,3,1,"chain",2,12.2908821406593
5.20627130947732,1,11.8861950834885,4,31.6348771436233,7,1,"chain",6,26.428605834146
5.98678483593835,1,11.8861950834885,4,20.7071837804446,5,1,"chain",4,14.7203989445062
8.69863433344351,1,11.8861950834885,4,28.360925846609,6,1,"chain",5,19.6622915131655
8.91809910768705,1,11.8861950834885,4,35.4407214105643,9,1,"chain",8,26.5226223028773
0.934093723978823,2,2.11608346211724,1,4.6473836052893,4,1,"chain",2,3.71328988131048
1.70508530915423,2,2.11608346211724,1,14.1060414257976,9,1,"chain",7,12.4009561166434
2.72910349153146,2,16.7779049834773,2,54.1666082048773,10,1,"chain",8,51.4375047133458
4.77169769703555,2,16.7779049834773,2,52.4364160893727,8,1,"chain",6,47.6647183923372
6.2465337893938,2,16.7779049834773,2,41.0900960021525,7,1,"chain",5,34.8435622127587
6.4020176824494,2,16.7779049834773,2,52.4364160893727,8,1,"chain",6,46.0343984069233
6.55688782733213,2,16.7779049834773,2,54.1666082048773,10,1,"chain",8,47.6097203775452
9.11695809787854,2,16.7779049834773,2,29.8120872369596,4,1,"chain",2,20.6951291390811
9.65877571501553,2,16.7779049834773,2,29.8120872369596,4,1,"chain",2,20.1533115219441
10.1096705806886,2,16.7779049834773,2,52.4364160893727,8,1,"chain",6,42.3267455086841
0.529884834308177,3,3.95561834254398,1,8.2188927772607,5,1,"chain",2,7.68900794295252
2.36663604379612,3,3.95561834254398,1,12.3011970336029,8,1,"chain",5,9.93456098980678
3.28555938914854,3,30.6387288105422,5,40.0509244090309,7,1,"chain",4,36.7653650198824
4.06027915293407,3,30.6387288105422,5,41.6291993700422,8,1,"chain",5,37.5689202171081
5.10903231573803,3,30.6387288105422,5,47.0256212577841,10,1,"chain",7,41.9165889420461
7.50620858580089,3,17.7399360423366,5,21.7298948963947,1,1,"chain",2,14.2236863105938
8.92596418370064,3,30.6387288105422,5,47.0256212577841,10,1,"chain",7,38.0996570740835
9.46643352747466,3,30.6387288105422,5,40.0509244090309,7,1,"chain",4,30.5844908815562
10.3239994229448,3,30.6387288105422,5,42.5165088872063,9,1,"chain",6,32.1925094642615
10.5618840632587,3,30.6387288105422,5,36.2238733954674,6,1,"chain",3,25.6619893322087
4.87395115168699,4,33.2472915473665,3,41.0900960021525,7,1,"chain",3,36.2161448504655
5.90998470423714,4,33.2472915473665,3,37.4356381378674,6,1,"chain",2,31.5256534336303
6.11771945637311,4,16.898486681238,5,20.1806442195989,2,1,"chain",2,14.0629247632258
1.51230789671298,5,8.2188927772607,1,14.1060414257976,9,1,"chain",4,12.5937335290846
5.2045113567112,5,8.2188927772607,1,10.66386144606,7,1,"chain",2,5.4593500893488
9.88041436630278,5,37.0094520652272,3,46.5356045712647,9,1,"chain",4,36.6551902049619
0.553676369599998,6,1.91992121934891,3,4.52326286821222,10,1,"chain",4,3.96958649861222
6.97402959195831,6,8.34734992884991,5,20.1806442195989,2,1,"chain",4,13.2066146276406
12.492008061209,6,32.5473737330915,1,39.0324346952922,2,1,"chain",4,26.5404266340832
3.3154268406173,7,5.65057186136002,5,20.1806442195989,2,1,"chain",5,16.8652173789816
6.91755484652177,7,10.66386144606,1,15.7612987739066,10,1,"chain",3,8.84374392738483
9.8286177668478,7,29.8025781057427,1,39.0324346952922,2,1,"chain",5,29.2038169284444
4.0292398474952,8,13.830260531191,3,18.7658466278823,3,1,"chain",5,14.7366067803871
6.30205325768296,8,13.830260531191,3,23.0320744608056,1,1,"chain",7,16.7300212031226
7.52123700906489,8,13.830260531191,3,20.2902212427014,2,1,"chain",6,12.7689842336365
0.421068592307468,9,2.16034608706832,5,17.7399360423366,3,1,"chain",6,17.3188674500291
2.17978740731875,9,9.54157983374519,3,20.2902212427014,2,1,"chain",7,18.1104338353827
5.21742715796733,9,9.54157983374519,3,16.4470212592068,6,1,"chain",3,11.2295941012395
4.77427120602934,10,6.39216538073252,3,13.830260531191,8,1,"chain",2,9.05598932516166
5.67066814518748,10,6.39216538073252,3,16.4470212592068,6,1,"chain",4,10.7763531140193
7.6581691151289,10,25.9737750967612,1,35.1080325867414,4,1,"chain",6,27.4498634716125
0.752411687704635,1,1,1,17.4679931595677,6,1,"chain",5,16.7155814718631
1.24654548750715,1,13.9302313403142,4,32.5868431960873,10,1,"chain",9,31.3402977085802
1.454364062171,1,13.9302313403142,4,19.446199328369,3,1,"chain",2,17.991835266198
2.50891478623304,1,13.9302313403142,4,23.1454653209949,5,1,"chain",4,20.6365505347619
3.22866760685948,1,13.9302313403142,4,25.9448621889106,6,1,"chain",5,22.7161945820511
3.41181382032197,1,13.9302313403142,4,19.446199328369,3,1,"chain",2,16.034385508047
3.75951163152319,1,13.9302313403142,4,27.9702977461616,8,1,"chain",7,24.2107861146384
4.41145648814824,1,13.9302313403142,4,27.9702977461616,8,1,"chain",7,23.5588412580134
4.52229618722891,1,13.9302313403142,4,29.9255051709748,9,1,"chain",8,25.4032089837459
4.82423288866691,1,13.9302313403142,4,23.1454653209949,5,1,"chain",4,18.321232432328
0.684774168301374,2,3.4865928022079,1,22.740013403709,9,1,"chain",7,22.0552392354076
1.85329539371179,2,3.4865928022079,1,15.9451328019367,5,1,"chain",3,14.0918374082249
2.34949729214878,2,3.4865928022079,1,17.4679931595677,6,1,"chain",4,15.1184958674189
2.49346649863768,2,3.4865928022079,1,26.7699698482579,10,1,"chain",8,24.2765033496202
3.03118556070153,2,19.1153047156618,2,43.5232643611528,10,1,"chain",8,40.4920788004513
5.4305724374267,2,19.1153047156618,2,31.4797869879761,6,1,"chain",4,26.0492145505494
6.58262144521024,2,19.1153047156618,2,36.1145923814087,7,1,"chain",5,29.5319709361985
8.48584647215097,2,19.1153047156618,2,31.4797869879761,6,1,"chain",4,22.9939405158251
8.74404787150337,2,19.1153047156618,2,25.2776858641103,4,1,"chain",2,16.5336379926069
10.1146567563026,2,19.1153047156618,2,36.1145923814087,7,1,"chain",5,25.9999356251061
0.246241589597982,3,19.8727385470742,2,38.4611276907946,8,1,"chain",5,38.2148861011966
1.34732863913708,3,19.8727385470742,2,31.4797869879761,6,1,"chain",3,30.132458348839
6.18221836746097,3,19.8727385470742,2,36.1145923814087,7,1,"chain",4,29.9323740139477
7.84271512262248,3,19.8727385470742,2,43.5232643611528,10,1,"chain",7,35.6805492385303
9.55080344735697,3,19.8727385470742,2,27.8912388841283,5,1,"chain",2,18.3404354367713
9.9202010941045,3,19.8727385470742,2,27.8912388841283,5,1,"chain",2,17.9710377900238
10.3560769117722,3,19.8727385470742,2,38.4611276907946,8,1,"chain",5,28.1050507790224
10.4587252361053,3,28.0542139005887,5,34.3665536174399,1,1,"chain",2,23.9078283813346
10.7450169941695,3,28.0542139005887,5,34.3665536174399,1,1,"chain",2,23.6215366232704
11.7850022150068,3,19.8727385470742,2,43.5232643611528,10,1,"chain",7,31.738262146146
2.11022429168224,4,48.8969836447126,5,56.6918768654473,6,1,"chain",2,54.5816525737651
5.87820189991001,4,48.8969836447126,5,61.2136726229561,9,1,"chain",5,55.3354707230461
12.5844822478315,4,25.3135656129518,5,29.5748142865992,2,1,"chain",2,16.9903320387677
3.18052456828123,5,55.4023077687392,5,61.2136726229561,9,1,"chain",4,58.0331480546749
7.15539930798679,5,55.4023077687392,5,60.96572537522,8,1,"chain",3,53.8103260672332
15.7156445618032,5,55.4023077687392,5,58.2920777394801,7,1,"chain",2,42.5764331776769
0.92064575117704,6,24.6916718139422,3,25.7094952701597,4,1,"chain",2,24.7888495189827
8.14149241307575,6,24.6916718139422,3,29.5748142865992,2,1,"chain",4,21.4333218735235
8.84047484059332,6,17.4679931595677,1,26.7699698482579,10,1,"chain",4,17.9294950076646
0.435239310849783,7,13.4888145130376,5,28.0542139005887,3,1,"chain",4,27.6189745897389
8.97494316509982,7,13.4888145130376,5,28.0542139005887,3,1,"chain",4,19.0792707354889
11.0308911925094,7,13.4888145130376,5,28.0542139005887,3,1,"chain",4,17.0233227080793
9.59084489993606,8,13.260275378429,5,18.5100932740191,5,1,"chain",3,8.91924837408304
12.7413753014133,8,13.260275378429,5,29.5748142865992,2,1,"chain",6,16.8334389851859
18.4089903807647,8,21.8859153943915,1,26.7699698482579,10,1,"chain",2,8.3609794674932
0.185550573902826,9,1.78961211908609,5,13.4888145130376,7,1,"chain",2,13.3032639391348
2.33685492072254,9,21.9543659290715,3,24.9377778210956,5,1,"chain",4,22.6009229003731
2.71336841757937,9,21.9543659290715,3,34.3665536174399,1,1,"chain",8,31.6531851998605
12.5683558166476,10,20.245687546608,3,24.9377778210956,5,1,"chain",5,12.369422004448
15.0158885641367,10,20.245687546608,3,24.9377778210956,5,1,"chain",5,9.9218892569589
21.7543836143006,10,32.2645033104558,1,59.2490187740927,2,1,"chain",8,37.4946351597921
0.523983996827155,1,1,1,34.159232788999,10,1,"chain",9,33.6352487921718
5.25753200075529,1,10.0497087701679,2,21.2019549080678,3,1,"chain",2,15.9444229073125
6.11128591259117,1,10.0497087701679,2,30.6000155585723,7,1,"chain",6,24.4887296459811
8.92932733313052,1,10.0497087701679,2,38.726190997517,9,1,"chain",8,29.7968636643865
8.97625721783248,1,10.0497087701679,2,23.5614881249007,5,1,"chain",4,14.5852309070682
10.0034209785271,1,17.9308978802493,4,30.4507528277507,6,1,"chain",5,20.4473318492236
10.0190920315615,1,17.9308978802493,4,25.3952618446877,4,1,"chain",3,15.3761698131262
10.033023974922,1,17.9308978802493,4,23.0767311776719,3,1,"chain",2,13.0437072027499
10.2296141721033,1,17.9308978802493,4,31.4360189173003,7,1,"chain",6,21.206404745197
10.919409623342,1,17.9308978802493,4,23.0767311776719,3,1,"chain",2,12.1573215543299
0.101232885848679,2,2.96649424833407,1,24.8590956693985,9,1,"chain",7,24.7578627835498
4.63579084279882,2,16.2744998193991,2,41.610453332963,10,1,"chain",8,36.9746624901642
5.61113617389524,2,16.2744998193991,2,30.6000155585723,7,1,"chain",5,24.9888793846771
6.05622757023,2,16.2744998193991,2,41.610453332963,10,1,"chain",8,35.554225762733
6.63499214110695,2,16.2744998193991,2,22.0554753077957,4,1,"chain",2,15.4204831666888
6.83132558235227,2,32.3487737433901,5,62.1343438539121,10,1,"chain",8,55.3030182715598
10.6280314446495,2,32.3487737433901,5,51.6516095096328,8,1,"chain",6,41.0235780649833
10.6580904283628,2,32.3487737433901,5,62.1343438539121,10,1,"chain",8,51.4762534255493
10.6811133896343,2,32.3487737433901,5,41.5214927279972,4,1,"chain",2,30.8403793383629
12.0298328681771,2,32.3487737433901,5,48.6935782559985,7,1,"chain",5,36.6637453878214
1.45733310578773,3,8.61584040581809,1,19.1807724087202,7,1,"chain",4,17.7234393029325
2.12757247936363,3,8.61584040581809,1,34.159232788999,10,1,"chain",7,32.0316603096354
2.48905473638708,3,8.61584040581809,1,15.1851479127099,5,1,"chain",2,12.6960931763228
3.38426794264372,3,8.61584040581809,1,34.159232788999,10,1,"chain",7,30.7749648463553
3.76575134660955,3,10.5359405553312,4,14.5103471148256,1,1,"chain",2,10.744595768216
4.88675235769474,3,8.61584040581809,1,19.1807724087202,7,1,"chain",4,14.2940200510255
5.44435312737473,3,8.61584040581809,1,16.934411875204,6,1,"chain",3,11.4900587478293
5.47827621107285,3,8.61584040581809,1,15.1851479127099,5,1,"chain",2,9.70687170163705
5.9592711271282,3,8.61584040581809,1,24.8590956693985,9,1,"chain",6,18.8998245422703
8.71413600036674,3,23.0767311776719,4,30.4507528277507,6,1,"chain",3,21.736616827384
4.49510323180163,4,25.3952618446877,4,41.428519977402,10,1,"chain",6,36.9334167456004
10.9307528003575,4,20.1512328199263,5,28.5260990202947,1,1,"chain",3,17.5953462199372
12.2793980155906,4,25.3952618446877,4,37.0332654722466,8,1,"chain",4,24.753867456656
0.418696896854967,5,1,4,13.9736913649178,2,1,"chain",3,13.5549944680628
3.84780599075851,5,47.1610347283231,5,62.1343438539121,10,1,"chain",5,58.2865378631536
4.67034888104396,5,47.1610347283231,5,62.1343438539121,10,1,"chain",5,57.4639949728681
0.238293995875072,6,5.45551994610275,3,11.8364234119717,10,1,"chain",4,11.5981294160966
1.02735835870885,6,5.45551994610275,3,7.1475259066151,8,1,"chain",2,6.12016754790625
7.3914072084257,6,30.4507528277507,4,37.0332654722466,8,1,"chain",2,29.6418582638209
5.58756367621873,7,12.001077729429,5,20.1512328199263,4,1,"chain",3,14.5636691437076
6.24481352715678,7,12.001077729429,5,20.1512328199263,4,1,"chain",3,13.9064192927695
15.1751598778536,7,21.5666978346696,3,31.7850321177399,1,1,"chain",6,16.6098722398863
1.38652167593439,8,9.61723668072695,5,20.1512328199263,4,1,"chain",4,18.7647111439919
5.64931890913252,8,9.61723668072695,5,19.6050727309811,5,1,"chain",3,13.9557538218486
10.546147018458,8,18.442926810817,3,23.3814377163718,6,1,"chain",2,12.8352906979138
0.811460926197469,9,6.63190911676655,5,19.6050727309811,5,1,"chain",4,18.7936118047836
9.38012370458263,9,16.0345902907438,3,21.5666978346696,7,1,"chain",2,12.186574130087
9.40767290783402,9,16.0345902907438,3,23.3814377163718,6,1,"chain",3,13.9737648085378
1.11118267612677,10,14.4074565124852,3,25.5186801069874,5,1,"chain",5,24.4074974308606
11.4261976108174,10,14.4074565124852,3,21.5666978346696,7,1,"chain",3,10.1405002238522
15.4907174754948,10,47.8688338192975,4,61.6335687895635,2,1,"chain",8,46.1428513140687
1.50514677125298,1,6.18705169439513,2,28.6356545820074,7,1,"chain",6,27.1305078107544
1.88205554963664,1,6.18705169439513,2,19.4352676691179,5,1,"chain",4,17.5532121194813
3.08321817190485,1,6.18705169439513,2,19.4352676691179,5,1,"chain",4,16.352049497213
4.30252299424815,1,6.18705169439513,2,32.3551207373183,9,1,"chain",8,28.0525977430702
4.65450681247372,1,6.18705169439513,2,22.0769456871128,6,1,"chain",5,17.4224388746391
6.54137611627182,1,10.1006198011521,4,28.0654547969,9,1,"chain",8,21.5240786806282
7.43531793992381,1,10.1006198011521,4,19.4352676691179,5,1,"chain",4,11.9999497291941
8.49978721528717,1,10.1006198011521,4,19.4352676691179,5,1,"chain",4,10.9354804538307
8.90978353158973,1,10.1006198011521,4,21.1580686565181,7,1,"chain",6,12.2482851249284
9.606578366467,1,10.1006198011521,4,13.3631966779211,3,1,"chain",2,3.7566183114541
0.19016660874637,2,5.63245546420045,1,23.8232540993079,10,1,"chain",8,23.6330874905615
2.11196430409512,2,5.63245546420045,1,8.19027105709888,4,1,"chain",2,6.07830675300376
2.45277293182113,2,5.63245546420045,1,14.487607393425,7,1,"chain",5,12.0348344616039
4.82009125457716,2,5.63245546420045,1,11.7405153563327,6,1,"chain",4,6.92042410175554
5.22920511386928,2,43.8372937339994,5,70.406281594946,7,1,"chain",5,65.1770764810767
10.6329835343364,2,43.8372937339994,5,72.2421158369502,9,1,"chain",7,61.6091323026138
11.855482841364,2,43.8372937339994,5,64.4189333718137,6,1,"chain",4,52.5634505304497
12.4566147890751,2,43.8372937339994,5,75.3652756432209,10,1,"chain",8,62.9086608541458
12.9194963397336,2,43.8372937339994,5,70.406281594946,7,1,"chain",5,57.4867852552124
14.5245502878881,2,43.8372937339994,5,72.2421158369502,9,1,"chain",7,57.7175655490621
0.529808280058205,3,6.64940747694324,1,21.1699124565022,9,1,"chain",6,20.640104176444
1.97474211941461,3,6.64940747694324,1,21.0982779345951,8,1,"chain",5,19.1235358151805
3.3550025375418,3,6.64940747694324,1,21.0982779345951,8,1,"chain",5,17.7432753970533
4.36264527136428,3,6.64940747694324,1,10.7832475869811,5,1,"chain",2,6.42060231561682
5.62278743655844,3,50.9236687446601,3,63.0366830488534,5,1,"chain",2,57.413895612295
6.77434602011874,3,50.9236687446601,3,72.0896692880996,8,1,"chain",5,65.3153232679809
6.93132298471156,3,50.9236687446601,3,77.3952603231508,10,1,"chain",7,70.4639373384392
9.47048718687333,3,28.5207110996532,5,34.8582977504355,1,1,"chain",2,25.3878105635622
9.92866581434804,3,50.9236687446601,3,63.0366830488534,5,1,"chain",2,53.1080172345054
12.0571686799413,3,50.9236687446601,3,64.5564202833788,6,1,"chain",3,52.4992516034375
8.87573688559445,4,16.9773321787397,4,25.3634498575499,8,1,"chain",4,16.4877129719554
11.7311741999546,4,16.9773321787397,4,20.3207576094818,6,1,"chain",2,8.5895834095272
13.2811814839526,4,16.9773321787397,4,20.3207576094818,6,1,"chain",2,7.0395761255292
1.18788312965383,5,19.4352676691179,2,28.6356545820074,7,1,"chain",2,27.4477714523536
3.0238879735892,5,24.6622178400959,3,32.5196844219861,3,1,"chain",2,29.4957964483969
4.49886572392037,5,19.4352676691179,2,28.6356545820074,7,1,"chain",2,24.136788858087
3.33335816846196,6,20.3207576094818,4,29.2579966384352,10,1,"chain",4,25.9246384699732
3.75004231605335,6,20.3207576094818,4,28.0654547969,9,1,"chain",3,24.3154124808466
5.92841245840891,6,20.3207576094818,4,29.2579966384352,10,1,"chain",4,23.3295841800263
6.82303094587533,7,22.5380897426895,5,34.4504333281749,2,1,"chain",5,27.6274023822996
7.6660017930275,7,22.5380897426895,5,34.4504333281749,2,1,"chain",5,26.7844315351474
7.76919520715949,7,28.6356545820074,2,32.3551207373183,9,1,"chain",2,24.5859255301588
0.722357568839347,8,15.4140317253321,5,24.3814407228568,4,1,"chain",4,23.6590831540175
4.80114009030162,8,15.4140317253321,5,34.4504333281749,2,1,"chain",6,29.6492932378733
5.25842482643822,8,15.4140317253321,5,24.3814407228568,4,1,"chain",4,19.1230158964186
0.644093942828476,9,5.85974861283727,5,24.2736251825826,5,1,"chain",4,23.6295312397541
18.2970789546279,9,37.8535769786385,4,51.8856324153794,1,1,"chain",8,33.5885534607515
31.1864546448836,9,37.8535769786385,4,46.2625993056012,3,1,"chain",6,15.0761446607176
1.22434337157756,10,14.0445527319815,3,32.5196844219861,3,1,"chain",7,31.2953410504085
2.64834302787979,10,14.0445527319815,3,25.3753995592798,4,1,"chain",6,22.7270565314
7.30192499280386,10,14.0445527319815,3,34.9450580788636,1,1,"chain",9,27.6431330860597
0.229469745885581,1,1,1,9.06765892264679,6,1,"chain",5,8.83818917676121
0.656227224040776,1,1,1,3.24012189940549,3,1,"chain",2,2.58389467536471
1.77247196850823,1,22.1086213022811,4,43.7803969502934,9,1,"chain",8,42.0079249817852
2.77299865000861,1,22.1086213022811,4,46.1750576160325,10,1,"chain",9,43.4020589660239
4.63887802727481,1,22.1086213022811,4,31.3967899832412,5,1,"chain",4,26.7579119559664
4.97939111554955,1,22.1086213022811,4,43.7803969502934,9,1,"chain",8,38.8010058347438
6.02533135448998,1,22.1086213022811,4,31.3967899832412,5,1,"chain",4,25.3714586287512
6.10898775167248,1,22.1086213022811,4,27.6138475674525,3,1,"chain",2,21.50485981578
6.75579825953996,1,22.1086213022811,4,28.7853813685398,4,1,"chain",3,22.0295831089998
7.26026920999816,1,22.1086213022811,4,28.7853813685398,4,1,"chain",3,21.5251121585416
0.557701739482582,2,1.9012237037532,1,10.9155192544147,7,1,"chain",5,10.3578175149321
4.98205965116484,2,24.6189964995397,2,31.6670803848979,5,1,"chain",3,26.6850207337331
4.99445581672741,2,24.6189964995397,2,46.5367636194705,8,1,"chain",6,41.5423078027431
5.99204447818472,2,24.6189964995397,2,37.507075063511,6,1,"chain",4,31.5150305853263
10.5621815204849,2,24.6189964995397,2,28.8700628797758,4,1,"chain",2,18.3078813592909
11.5757309702965,2,24.6189964995397,2,53.950171773119,10,1,"chain",8,42.3744408028225
11.7833882240947,2,24.6189964995397,2,28.8700628797758,4,1,"chain",2,17.0866746556811
12.4288240020531,2,24.6189964995397,2,50.0074805775308,9,1,"chain",7,37.5786565754777
17.378459136769,2,24.6189964995397,2,40.17970909547,7,1,"chain",5,22.801249958701
17.6797869040852,2,24.6189964995397,2,31.6670803848979,5,1,"chain",3,13.9872934808127
1.3234026999724,3,2.34672478070067,4,17.3074223263347,1,1,"chain",2,15.9840196263623
1.38762223947997,3,3.24012189940549,1,17.1606652625082,9,1,"chain",6,15.7730430230282
2.58036208841678,3,3.24012189940549,1,6.26224461818816,5,1,"chain",2,3.68188252977138
3.53352267607299,3,34.7344976000072,5,44.8445093061789,7,1,"chain",4,41.3109866301059
4.7602703183022,3,34.7344976000072,5,51.477410687946,10,1,"chain",7,46.7171403696438
6.78397180718989,3,34.7344976000072,5,46.5367636194705,8,1,"chain",5,39.7527918122806
7.95626449414673,3,18.9344749533625,5,23.0255486819771,1,1,"chain",2,15.0692841878304
8.25518775328207,3,18.9344749533625,5,23.0255486819771,1,1,"chain",2,14.770360928695
8.8066051597973,3,34.7344976000072,5,39.9330712133155,5,1,"chain",2,31.1264660535182
8.93662422106468,3,34.7344976000072,5,39.9330712133155,5,1,"chain",2,30.9964469922508
10.5351964130363,4,40.3065866056163,3,43.7818303646534,6,1,"chain",2,33.2466339516171
15.6895735091992,4,40.3065866056163,3,46.6918860439551,7,1,"chain",3,31.0023125347559
18.0010405162283,4,40.3065866056163,3,53.950171773119,10,1,"chain",6,35.9491312568907
11.4264265442254,5,31.3967899832412,4,42.559332875164,8,1,"chain",3,31.1329063309386
15.0022923535806,5,31.3967899832412,4,39.5476856752921,7,1,"chain",2,24.5453933217115
21.0116200977447,5,31.8357268449494,1,35.8029097160525,2,1,"chain",3,14.7912896183078
0.677316804509754,6,17.7391501967098,3,27.4683163576626,3,1,"chain",3,26.7909995531528
2.59150013274838,6,9.06765892264679,1,13.078310204558,8,1,"chain",2,10.4868100718096
5.315431935424,6,17.7391501967098,3,19.6913057916674,4,1,"chain",2,14.3758738562434
10.1725827896954,7,14.3435510912384,5,16.767609836702,5,1,"chain",2,6.5950270470066
10.9417195410765,7,14.3435510912384,5,18.0342783114693,4,1,"chain",3,7.0925587703928
14.500488586955,7,26.5033359135555,1,31.8357268449494,5,1,"chain",2,17.3352382579944
8.82743776423447,8,11.4152994549678,5,16.767609836702,5,1,"chain",3,7.94017207246753
9.05571752428914,8,11.4152994549678,5,23.0255486819771,1,1,"chain",7,13.969831157688
9.53026538302903,8,11.4152994549678,5,23.0255486819771,1,1,"chain",7,13.4952832989481
1.71364137592415,9,5.44040271987147,5,23.0255486819771,1,1,"chain",8,21.3119073060529
5.01225423985128,9,13.5846007234931,3,29.9587611647108,2,1,"chain",7,24.9465069248595
7.69148803908932,9,13.5846007234931,3,16.6456673757407,7,1,"chain",2,8.95417933665138
1.07946600467131,10,10.6011046726621,3,17.7391501967098,6,1,"chain",4,16.6596841920385
2.76134660480087,10,10.6011046726621,3,29.9587611647108,2,1,"chain",8,27.1974145599099
9.96347202579555,10,10.6011046726621,3,17.7391501967098,6,1,"chain",4,7.77567817091425
0.406079894863069,1,1,1,19.6250903942416,7,1,"chain",6,19.2190104993785
1.87219533222708,1,9.1966424699511,4,37.6166477401285,10,1,"chain",9,35.7444524079014
2.11363326038072,1,9.1966424699511,4,34.0636531301207,8,1,"chain",7,31.95001986974
3.41813366135876,1,9.1966424699511,4,23.4123516916498,5,1,"chain",4,19.994218030291
3.60081580115776,1,9.1966424699511,4,36.6436140083252,9,1,"chain",8,33.0427982071674
4.72267246914846,1,9.1966424699511,4,20.3018391402856,4,1,"chain",3,15.5791666711371
5.60335270113652,1,9.1966424699511,4,19.5653628569747,3,1,"chain",2,13.9620101558382
7.28618105849571,1,9.1966424699511,4,36.6436140083252,9,1,"chain",8,29.3574329498295
8.68929653055181,1,9.1966424699511,4,30.4053736719252,7,1,"chain",6,21.7160771413734
8.80039353388508,1,9.1966424699511,4,36.6436140083252,9,1,"chain",8,27.8432204744401
0.256695441901684,2,7.11882629717347,1,15.5164150599194,5,1,"chain",3,15.2597196180177
0.376832588248858,2,7.11882629717347,1,25.2568380300333,8,1,"chain",6,24.8800054417844
1.43751385917974,2,7.11882629717347,1,19.6250903942416,7,1,"chain",5,18.1875765350619
2.42111564149137,2,7.11882629717347,1,19.6250903942416,7,1,"chain",5,17.2039747527502
3.36722751144764,2,7.11882629717347,1,32.9520554544979,9,1,"chain",7,29.5848279430503
3.45249927311096,2,7.11882629717347,1,17.2100740261862,6,1,"chain",4,13.7575747530752
5.38198663180566,2,7.11882629717347,1,14.6549057220641,4,1,"chain",2,9.27291909025844
10.4814869169731,2,12.3308798426026,2,42.8559224849242,8,1,"chain",6,32.3744355679511
10.5805579963726,2,12.3308798426026,2,21.3109721383265,4,1,"chain",2,10.7304141419539
12.0198610568395,2,23.0537096239392,5,25.4509121085506,5,1,"chain",3,13.4310510517111
0.593870745506138,3,19.5653628569747,2,31.4162110878123,6,1,"chain",3,30.8223403423062
3.71700307104697,3,19.5653628569747,2,37.3668908809645,7,1,"chain",4,33.6498878099175
4.15503180149903,3,19.5653628569747,2,31.4162110878123,6,1,"chain",3,27.2611792863133
5.08252078972241,3,19.5653628569747,2,46.342241724624,10,1,"chain",7,41.2597209349016
5.50676693067208,3,19.5653628569747,2,46.342241724624,10,1,"chain",7,40.8354747939519
7.22648280123409,3,19.5653628569747,2,31.4162110878123,6,1,"chain",3,24.1897282865782
7.69802904511031,3,19.5653628569747,2,46.342241724624,10,1,"chain",7,38.6442126795137
8.61121021775214,3,19.5653628569747,2,43.6736171966335,9,1,"chain",6,35.0624069788814
8.89213236333487,3,19.5653628569747,2,43.6736171966335,9,1,"chain",6,34.7814848332986
8.98190256002549,3,19.5653628569747,2,31.4162110878123,6,1,"chain",3,22.4343085277868
1.95469996581475,4,24.3656934175924,5,39.1783540724027,10,1,"chain",6,37.223654106588
2.00276898064961,4,10.6211966893911,5,15.7474087605676,1,1,"chain",3,13.744639779918
2.93129108225306,4,10.6211966893911,5,12.0715416876142,2,1,"chain",2,9.14025060536114
0.00408165001620849,5,1,4,3.93997328499479,1,1,"chain",4,3.93589163497858
2.38018019576524,5,25.4509121085506,5,38.9238227397851,9,1,"chain",4,36.5436425440199
4.49285635865881,5,25.4509121085506,5,37.8068328383347,8,1,"chain",3,33.3139764796759
1.71295890118927,6,4.4171965369634,5,10.6211966893911,4,1,"chain",2,8.90823778820183
5.35411353640324,6,64.1197136143518,5,75.5858944515706,1,1,"chain",5,70.2317809151673
5.82702235021696,6,31.4162110878123,5,37.8068328383347,8,1,"chain",2,31.9798104881177
3.78123220973615,7,19.6250903942416,1,33.6077774317814,10,1,"chain",3,29.8265452220453
4.62178926776555,7,59.2211841425414,5,68.7826694814087,4,1,"chain",3,64.1608802136432
12.0290792529128,7,59.2211841425414,5,75.0175836427003,3,1,"chain",4,62.9885043897875
4.29033178822104,8,19.9976509952932,3,38.4766567095549,1,1,"chain",7,34.1863249213339
6.07504717525993,8,19.9976509952932,3,30.929565227153,3,1,"chain",5,24.8545180518931
10.475713466014,8,19.9976509952932,3,24.8249345507224,5,1,"chain",3,14.3492210847084
2.42984088713745,9,19.6494519915259,3,34.4265735825028,2,1,"chain",7,31.9967326953653
7.53978693437884,9,19.6494519915259,3,20.710905499457,6,1,"chain",3,13.1711185650782
15.5620018470786,9,19.6494519915259,3,34.4265735825028,2,1,"chain",7,18.8645717354242
3.18589692051405,10,13.4610597954274,3,38.4766567095549,1,1,"chain",9,35.2907597890409
16.3791989439698,10,47.0137367249217,5,64.1197136143518,6,1,"chain",4,47.740514670382
18.3848198982176,10,47.0137367249217,5,57.0395941212224,8,1,"chain",2,38.6547742230048
0.104765262271276,1,1,1,19.4194446585795,8,1,"chain",7,19.3146793963082
1.97875685590579,1,4.82926797860721,2,19.6671364411744,6,1,"chain",5,17.6883795852686
4.30319349242138,1,14.6268777966045,4,31.7326124143976,9,1,"chain",8,27.4294189219762
4.4300723193048,1,14.6268777966045,4,25.5395257851318,5,1,"chain",4,21.109453465827
4.62933350032523,1,14.6268777966045,4,31.7326124143976,9,1,"chain",8,27.1032789140724
11.0239384045243,1,14.6268777966045,4,41.1024872810091,10,1,"chain",9,30.0785488764848
11.5574590281002,1,14.6268777966045,4,31.7326124143976,9,1,"chain",8,20.1751533862974
11.6833430567175,1,14.6268777966045,4,30.2665463484779,8,1,"chain",7,18.5832032917604
12.0427575564362,1,14.6268777966045,4,28.3190507949397,6,1,"chain",5,16.2762932385035
12.4884619271732,1,14.6268777966045,4,31.7326124143976,9,1,"chain",8,19.2441504872244
3.5888545854607,2,11.112662526407,2,18.0353059836943,4,1,"chain",2,14.4464513982336
3.63864681745258,2,11.112662526407,2,25.9690718279327,9,1,"chain",7,22.3304250104801
3.92415052807269,2,11.112662526407,2,22.9186524243739,8,1,"chain",6,18.9945018963012
4.17124216417952,2,11.112662526407,2,21.5351756403003,7,1,"chain",5,17.3639334761208
4.21123622360493,2,11.112662526407,2,19.6671364411744,6,1,"chain",4,15.4559002175695
4.51701552600402,2,11.112662526407,2,22.9186524243739,8,1,"chain",6,18.4016368983699
5.64035971824338,2,11.112662526407,2,22.9186524243739,8,1,"chain",6,17.2782927061305
7.82482714368724,2,11.112662526407,2,27.6160365898967,10,1,"chain",8,19.7912094462095
8.16447901696475,2,11.112662526407,2,22.9186524243739,8,1,"chain",6,14.7541734074091
8.62017931294205,2,11.112662526407,2,22.9186524243739,8,1,"chain",6,14.2984731114318
4.07874849976456,3,14.8244072172091,5,19.6257411901322,1,1,"chain",2,15.5469926903676
4.49097887591875,3,5.35078436430821,1,20.8902052821337,9,1,"chain",6,16.399226406215
4.60028353247564,3,5.35078436430821,1,22.0116915440165,10,1,"chain",7,17.4114080115409
4.86733148067962,3,5.35078436430821,1,9.48306042446207,5,1,"chain",2,4.61572894378245
6.74190323984934,3,27.8695867580502,5,41.0885820891561,6,1,"chain",3,34.3466788493068
7.14603906697709,3,27.8695867580502,5,32.8346887535012,5,1,"chain",2,25.6886496865241
7.22664847611565,3,27.8695867580502,5,41.0885820891561,6,1,"chain",3,33.8619336130404
7.38415715997672,3,27.8695867580502,5,46.3067615243417,8,1,"chain",5,38.922604364365
8.16957676256996,3,27.8695867580502,5,46.3375601799687,9,1,"chain",6,38.1679834173987
8.80612207329821,3,27.8695867580502,5,46.3375601799687,9,1,"chain",6,37.5314381066705
1.05808284599334,4,8.37297706251417,1,13.1097881253335,7,1,"chain",3,12.0517052793402
1.1359270910422,4,8.37297706251417,1,19.4194446585795,8,1,"chain",4,18.2835175675373
16.5709893024507,4,47.0293155381688,3,58.3324574355268,10,1,"chain",6,41.7614681330761
4.33796616245334,5,47.9916771192956,3,54.560954656463,8,1,"chain",3,50.2229884940097
4.66944909295586,5,47.9916771192956,3,58.3324574355268,10,1,"chain",5,53.6630083425709
10.9828343110577,5,47.9916771192956,3,57.3585876163258,9,1,"chain",4,46.3757533052681
3.51943965055947,6,4.68929112787339,5,10.7431130171187,4,1,"chain",2,7.22367336655923
7.35391594441541,6,41.0885820891561,5,51.3357644416292,10,1,"chain",4,43.9818484972138
8.53476454182587,6,41.0885820891561,5,46.3067615243417,8,1,"chain",2,37.7719969825158
9.01925406687172,7,33.5068701869869,1,44.2416147910008,3,1,"chain",4,35.2223607241291
30.4769682494884,7,33.5068701869869,1,42.1465839857914,4,1,"chain",3,11.669615736303
32.6295616197938,7,41.8578623190102,5,51.3357644416292,10,1,"chain",3,18.7062028218354
13.3065535804085,8,17.3240098384112,3,31.4629577025236,4,1,"chain",4,18.1564041221151
13.5598327460837,8,17.3240098384112,3,34.8189444478439,1,1,"chain",7,21.2591117017602
14.3059629334586,8,19.4194446585795,1,22.0116915440165,10,1,"chain",2,7.7057286105579
4.72474902634084,9,14.9113588562341,3,34.3889459041519,2,1,"chain",7,29.6641968778111
6.37159966784725,9,14.9113588562341,3,26.2838339440816,5,1,"chain",4,19.9122342762344
21.6239153298083,9,28.624950449306,1,44.2416147910008,3,1,"chain",6,22.6176994611925
5.01766168794839,10,14.489544823125,3,20.8744770229969,6,1,"chain",4,15.8568153350485
5.64304252282339,10,14.489544823125,3,17.3240098384112,8,1,"chain",2,11.6809673155878
7.95914804365697,10,14.489544823125,3,17.3240098384112,8,1,"chain",2,9.36486179475423
0.272599509241131,1,1,1,18.6013026619246,9,1,"chain",8,18.3287031526835
0.273680146107522,1,1,1,10.6007386131252,5,1,"chain",4,10.3270584670177
0.430894539383189,1,1,1,10.6007386131252,5,1,"chain",4,10.169844073742
0.659904305514828,1,1,1,11.0802658421155,6,1,"chain",5,10.4203615366007
3.1775094498635,1,5.22215751706069,2,13.4805629683959,3,1,"chain",2,10.3030535185324
4.44294837436505,1,5.22215751706069,2,35.030359181726,10,1,"chain",9,30.5874108073609
5.662921649761,1,15.8295030854422,4,29.2726965082786,3,1,"chain",2,23.6097748585176
6.07870091390209,1,15.8295030854422,4,39.93964247763,7,1,"chain",6,33.8609415637279
7.40833787415045,1,15.8295030854422,4,39.93964247763,7,1,"chain",6,32.5313046034796
9.36838868605753,1,15.8295030854422,4,39.93964247763,7,1,"chain",6,30.5712537915725
0.217095423924635,2,2.2681370513048,1,15.3492376954858,8,1,"chain",6,15.1321422715612
0.339864975617479,2,2.2681370513048,1,11.0802658421155,6,1,"chain",4,10.740400866498
0.749954416383581,2,2.2681370513048,1,15.3492376954858,8,1,"chain",6,14.5992832791022
0.809867968713033,2,2.2681370513048,1,15.3492376954858,8,1,"chain",6,14.5393697267728
1.40740853867038,2,7.78249028442639,2,16.1721630702838,5,1,"chain",3,14.7647545316134
1.45028996088086,2,7.78249028442639,2,25.1143605391753,9,1,"chain",7,23.6640705782944
1.836922163074,2,7.78249028442639,2,20.2807584360858,6,1,"chain",4,18.4438362730118
2.63806089717638,2,7.78249028442639,2,35.030359181726,10,1,"chain",8,32.3922982845496
5.67228604474779,2,7.78249028442639,2,14.4423025095478,4,1,"chain",2,8.77001646480001
6.23608016496267,2,7.78249028442639,2,35.030359181726,10,1,"chain",8,28.7942790167633
3.04466629011517,3,29.2726965082786,4,39.93964247763,7,1,"chain",4,36.8949761875148
3.57329374209007,3,29.2726965082786,4,56.1798420621755,10,1,"chain",7,52.6065483200854
5.10861913322411,3,11.4443750637973,5,21.0639957482547,1,1,"chain",2,15.9553766150306
7.39901656293686,3,29.2726965082786,4,39.93964247763,7,1,"chain",4,32.5406259146931
7.62310528577681,3,29.2726965082786,4,52.9935251973916,9,1,"chain",6,45.3704199116148
8.29310602377545,3,29.2726965082786,4,30.5695892274724,5,1,"chain",2,22.2764832036969
8.32868635882775,3,29.2726965082786,4,30.5695892274724,5,1,"chain",2,22.2409028686446
8.61174565615695,3,29.2726965082786,4,30.5695892274724,5,1,"chain",2,21.9578435713155
11.517664489957,3,29.2726965082786,4,34.6042862050955,6,1,"chain",3,23.0866217151385
11.5766869321026,3,30.7648649286933,5,46.4123581103032,8,1,"chain",5,34.8356711782006
1.56902121690412,4,31.4091002716206,5,39.93964247763,7,1,"chain",3,38.3706212607259
7.76054325179822,4,31.4091002716206,5,39.93964247763,7,1,"chain",3,32.1790992258318
8.76792978782521,4,31.4091002716206,5,52.9935251973916,9,1,"chain",5,44.2255954095664
3.41885806668206,5,35.6359882624063,5,46.4123581103032,8,1,"chain",3,42.9935000436211
4.93292769403164,5,35.6359882624063,5,56.1798420621755,10,1,"chain",5,51.2469143681439
7.66110934058045,5,35.6359882624063,5,39.93964247763,7,1,"chain",2,32.2785331370495
0.791958911015514,6,2.33527476899326,3,13.556626339942,10,1,"chain",4,12.7646674289265
6.19671301895802,6,10.2690782433152,5,11.4443750637973,3,1,"chain",3,5.24766204483928
13.2208574805373,6,47.7317935804474,3,56.1798420621755,10,1,"chain",4,42.9589845816382
0.494751797205028,7,9.72569345280155,5,10.8504122664928,5,1,"chain",2,10.3556604692878
0.672778661510167,7,4.83910195525716,3,13.556626339942,10,1,"chain",3,12.8838476784318
10.6014591951142,7,14.785627743891,1,18.6013026619246,9,1,"chain",2,7.9998434668104
0.120555673105021,8,5.65770419549157,5,11.4443750637973,3,1,"chain",5,11.3238193906923
6.14954870321411,8,25.2229088629545,3,31.556827217088,4,1,"chain",4,25.4072785138739
6.86861454240244,8,25.2229088629545,3,34.7365910715174,1,1,"chain",7,27.867976529115
0.17977986484766,9,2.19124735370278,5,11.4443750637973,3,1,"chain",6,11.2645951989496
4.46067998482192,9,18.6891283302152,3,28.3469327583426,7,1,"chain",2,23.8862527735207
5.23334712396963,9,18.6891283302152,3,28.3469327583426,7,1,"chain",2,23.113585634373
0.762836113572121,10,1,5,21.0639957482547,1,1,"chain",9,20.3011596346826
13.4964306086751,10,18.0708667257385,3,28.3469327583426,7,1,"chain",3,14.8505021496675
18.0728261692119,10,24.2342988924362,1,49.3636028314263,2,1,"chain",8,31.2907766622144
1.18294740334208,1,4.66638208553195,2,25.3338850179236,10,1,"chain",9,24.1509376145815
1.37997126284594,1,4.66638208553195,2,15.4891987988969,7,1,"chain",6,14.109227536051
2.09290688931074,1,4.66638208553195,2,14.8815628496661,6,1,"chain",5,12.7886559603554
2.15360852870222,1,4.66638208553195,2,23.2835155147129,9,1,"chain",8,21.1299069860107
2.58612055824201,1,4.66638208553195,2,11.817259337907,4,1,"chain",3,9.23113877966499
3.32766800216664,1,4.66638208553195,2,14.8815628496661,6,1,"chain",5,11.5538948474995
6.0147723259195,1,14.2393478668796,4,30.4472192597626,8,1,"chain",7,24.4324469338431
8.42754065435585,1,14.2393478668796,4,21.6698547158517,3,1,"chain",2,13.2423140614958
9.59153970516948,1,14.2393478668796,4,33.2357968183306,10,1,"chain",9,23.6442571131611
10.6248011509254,1,14.2393478668796,4,32.0386021127135,9,1,"chain",8,21.4138009617881
0.932573629501176,2,4.8860086610723,1,21.0519569775936,8,1,"chain",6,20.1193833480924
2.33143701950524,2,4.8860086610723,1,28.2810494552907,10,1,"chain",8,25.9496124357855
2.43480412709945,2,4.8860086610723,1,21.0519569775936,8,1,"chain",6,18.6171528504942
2.54791040766471,2,4.8860086610723,1,28.2810494552907,10,1,"chain",8,25.733139047626
3.62519815887267,2,4.8860086610723,1,28.2810494552907,10,1,"chain",8,24.655851296418
4.23502328150848,2,18.4585550158716,4,25.1192801081203,6,1,"chain",4,20.8842568266118
5.1899966932128,2,18.4585550158716,4,25.1192801081203,6,1,"chain",4,19.9292834149075
7.84360706972792,2,18.4585550158716,4,25.1192801081203,6,1,"chain",4,17.2756730383924
9.02510727545605,2,18.4585550158716,4,22.8247020654701,5,1,"chain",3,13.799594790014
9.05737994028614,2,26.4017081640731,5,31.9982635986961,4,1,"chain",2,22.94088365841
0.293009498450536,3,31.7011432179594,5,49.4743067261011,10,1,"chain",7,49.1812972276506
0.784166084896404,3,31.7011432179594,5,35.8795080902865,6,1,"chain",3,35.0953420053901
0.851793713991256,3,4.59490860439182,4,9.72283253011688,1,1,"chain",2,8.87103881612562
1.40504895861513,3,31.7011432179594,5,38.3533887901664,7,1,"chain",4,36.9483398315513
3.62520190840343,3,31.7011432179594,5,38.3533887901664,7,1,"chain",4,34.728186881763
3.81177433160821,3,4.59490860439182,4,9.72283253011688,1,1,"chain",2,5.91105819850867
5.49720981103105,3,31.7011432179594,5,49.4743067261011,10,1,"chain",7,43.97709691507
6.61725993115647,3,31.7011432179594,5,38.8634511573282,8,1,"chain",5,32.2461912261717
6.65270064898027,3,31.7011432179594,5,38.3533887901664,7,1,"chain",4,31.7006881411861
8.12916421278151,3,31.7011432179594,5,39.8138473063056,9,1,"chain",6,31.6846830935241
2.649483512947,4,31.9982635986961,5,39.8138473063056,9,1,"chain",5,37.1643637933586
5.5576007934591,4,31.9982635986961,5,38.3533887901664,7,1,"chain",3,32.7957879967073
5.75957204808104,4,31.9982635986961,5,38.3533887901664,7,1,"chain",3,32.5938167420854
0.615182948430763,5,1,3,4.9421028812309,7,1,"chain",2,4.32691993280014
0.834966872482625,5,1,4,4.59490860439182,3,1,"chain",2,3.7599417319092
1.25983464127193,5,16.1836631345444,5,19.5454300921995,3,1,"chain",2,18.2855954509276
0.84352700971067,6,2.09496691313455,3,8.26876798241095,8,1,"chain",2,7.42524097270028
2.75933962780982,6,34.7211979590476,2,42.0770769798103,4,1,"chain",2,39.3177373520005
3.63248077686876,6,34.7211979590476,2,47.5633261138249,2,1,"chain",4,43.9308453369561
1.2451483034293,7,4.9421028812309,3,18.799150699186,10,1,"chain",3,17.5540023957567
3.88548778710669,7,32.7906047914642,3,38.124667869015,5,1,"chain",2,34.2391800819083
10.3883675020408,7,32.7906047914642,3,46.3367253989497,2,1,"chain",5,35.9483578969089
5.48611389207223,8,6.97484181119037,5,16.1836631345444,5,1,"chain",3,10.6975492424722
7.84228848814918,8,30.3580275635986,3,54.9164366108875,1,1,"chain",7,47.0741481227383
9.96463603395922,8,30.3580275635986,3,38.124667869015,5,1,"chain",3,28.1600318350558
1.59996387162141,9,3.28053944526581,5,16.1836631345444,5,1,"chain",4,14.583699262923
2.35309320551645,9,3.28053944526581,5,23.3052464788584,1,1,"chain",8,20.9521532733419
2.37831477125477,9,3.28053944526581,5,21.4406227411086,2,1,"chain",7,19.0623079698538
0.45663519607236,10,1,5,19.5454300921995,3,1,"chain",7,19.0887948961271
1.87850315279017,10,25.125462304234,3,38.124667869015,5,1,"chain",5,36.2461647162248
3.52200759574771,10,25.125462304234,3,41.6878294241248,4,1,"chain",6,38.1658218283771
1.06339151035519,1,10.5838380516962,2,12.7605860283123,3,1,"chain",2,11.6971945179571
1.40980766243757,1,10.5838380516962,2,18.1379442477699,6,1,"chain",5,16.7281365853323
4.71080120166248,1,10.5838380516962,2,21.7190450397966,7,1,"chain",6,17.0082438381341
6.83998619382926,1,10.5838380516962,2,15.2957133788432,5,1,"chain",4,8.45572718501394
7.8524191620312,1,10.5838380516962,2,21.7190450397966,7,1,"chain",6,13.8666258777654
9.23339625988792,1,10.5838380516962,2,15.2957133788432,5,1,"chain",4,6.06231711895528
9.48102112309151,1,10.5838380516962,2,28.8674276819948,9,1,"chain",8,19.3864065589033
9.70432985349633,1,10.5838380516962,2,15.2957133788432,5,1,"chain",4,5.59138352534687
10.3161698175509,1,15.2651070761962,4,53.0159025171454,7,1,"chain",6,42.6997326995945
10.3226384847807,1,15.2651070761962,4,33.596465807178,5,1,"chain",4,23.2738273223973
0.974015208850515,2,1.85609672870487,1,27.3813217608926,8,1,"chain",6,26.4073065520421
3.04009411564533,2,16.7926337959338,4,54.4029512767555,8,1,"chain",6,51.3628571611102
3.07989626970578,2,16.7926337959338,4,54.4029512767555,8,1,"chain",6,51.3230550070497
3.38465848971594,2,16.7926337959338,4,59.1761052235087,10,1,"chain",8,55.7914467337928
5.03284563149741,2,16.7926337959338,4,59.1761052235087,10,1,"chain",8,54.1432595920113
5.86193948925959,2,16.7926337959338,4,33.596465807178,5,1,"chain",3,27.7345263179184
6.86903837447065,2,16.7926337959338,4,33.596465807178,5,1,"chain",3,26.7274274327074
10.0401041443922,2,16.7926337959338,4,53.0159025171454,7,1,"chain",5,42.9757983727532
11.7320526103112,2,16.7926337959338,4,53.0159025171454,7,1,"chain",5,41.2838499068342
13.1432610088673,2,16.7926337959338,4,31.3223089339908,4,1,"chain",2,18.1790479251235
0.15423442190513,3,4.81079512594228,1,18.4745258601381,6,1,"chain",3,18.320291438233
0.446069592610002,3,4.81079512594228,1,30.7127715839286,9,1,"chain",6,30.2667019913186
0.745194298680872,3,4.81079512594228,1,30.7127715839286,9,1,"chain",6,29.9675772852477
1.10934954146066,3,4.81079512594228,1,27.3813217608926,8,1,"chain",5,26.2719722194319
2.47749867202381,3,4.81079512594228,1,27.3813217608926,8,1,"chain",5,24.9038230888688
3.87742453903538,3,4.81079512594228,1,21.7190450397966,7,1,"chain",4,17.8416205007612
3.93195748838525,3,4.81079512594228,1,18.4745258601381,6,1,"chain",3,14.5425683717528
4.09458791228872,3,23.4982046924598,5,42.1688913030476,8,1,"chain",5,38.0743033907589
4.62285391890373,3,23.4982046924598,5,46.423068216795,10,1,"chain",7,41.8002142978913
6.58892906725316,3,23.4982046924598,5,43.7513311239352,9,1,"chain",6,37.162402056682
0.150340055247621,4,2.46576927133689,4,3.76525619399587,2,1,"chain",2,3.61491613874825
0.682587383136626,4,31.3223089339908,5,43.7513311239352,9,1,"chain",5,43.0687437407986
0.907605985410064,4,2.46576927133689,4,3.76525619399587,2,1,"chain",2,2.85765020858581
0.732478848658502,5,1,4,10.4711784736539,1,1,"chain",4,9.7386996249954
1.75860271323472,5,33.596465807178,5,46.423068216795,10,1,"chain",5,44.6644655035603
7.57790644780356,5,33.596465807178,5,43.7513311239352,9,1,"chain",4,36.1734246761316
4.54578701082273,6,30.4816818356695,3,41.5247782691119,1,1,"chain",5,36.9789912582892
7.66490691623894,6,30.4816818356695,3,41.5247782691119,1,1,"chain",5,33.859871352873
8.36989765958794,6,18.1379442477699,2,27.3813217608926,8,1,"chain",2,19.0114241013047
2.00381102195631,7,5.55380027760111,5,15.9232192943349,3,1,"chain",4,13.9194082723786
2.46712596931805,7,5.55380027760111,5,17.3144432548386,1,1,"chain",6,14.8473172855205
3.48439941271181,7,5.55380027760111,5,17.3144432548386,1,1,"chain",6,13.8300438421268
3.91938103286837,8,5.17378906770837,5,15.9232192943349,3,1,"chain",5,12.0038382614665
4.27481644089932,8,5.17378906770837,5,17.3144432548386,1,1,"chain",7,13.0396268139393
6.35041576113219,8,24.4692499612407,3,30.4816818356695,6,1,"chain",2,24.1312660745373
1.62148547358811,9,4.51857569678915,5,17.3144432548386,1,1,"chain",8,15.6929577812505
2.31231871983782,9,4.51857569678915,5,7.24878050162211,6,1,"chain",3,4.93646178178429
4.57580080402519,9,21.6697959242311,3,36.0494015655812,4,1,"chain",5,31.473600761556
2.61323497848214,10,21.5306194249407,3,27.2950309002771,7,1,"chain",3,24.681795921795
3.30023089020452,10,21.5306194249407,3,27.2950309002771,7,1,"chain",3,23.9948000100726
15.1341626648203,10,21.5306194249407,3,30.4816818356695,6,1,"chain",4,15.3475191708492
2.66949248860095,1,6.13714100310539,2,22.071058601424,8,1,"chain",7,19.401566112823
3.710801990052,1,6.13714100310539,2,19.0403690376278,7,1,"chain",6,15.3295670475758
4.16011638409135,1,6.13714100310539,2,25.6237175354953,10,1,"chain",9,21.4636011514039
7.1633870621455,1,21.4213830600147,4,29.8725841241887,6,1,"chain",5,22.7091970620432
7.8890065160403,1,21.4213830600147,4,43.2754641110391,10,1,"chain",9,35.3864575949988
8.19880774950702,1,21.4213830600147,4,35.5783238696585,8,1,"chain",7,27.3795161201515
8.33526774782781,1,21.4213830600147,4,26.576907079708,5,1,"chain",4,18.2416393318802
8.76260140918288,1,21.4213830600147,4,43.2754641110391,10,1,"chain",9,34.5128627018562
9.46533758382862,1,21.4213830600147,4,26.576907079708,5,1,"chain",4,17.1115694958794
9.66607071788599,1,21.4213830600147,4,35.5783238696585,8,1,"chain",7,25.9122531517725
1.45308650232831,2,3.92974152258511,1,10.8010875436888,4,1,"chain",2,9.34800104136049
2.96883599399549,2,3.92974152258511,1,10.8010875436888,4,1,"chain",2,7.83225154969331
3.34744914793369,2,9.98572104987683,2,22.071058601424,8,1,"chain",6,18.7236094534903
3.9034799312703,2,9.98572104987683,2,15.6310820698491,5,1,"chain",3,11.7276021385788
4.93734352671693,2,9.98572104987683,2,25.6237175354953,10,1,"chain",8,20.6863740087784
7.15611062353069,2,9.98572104987683,2,25.6237175354953,10,1,"chain",8,18.4676069119646
8.05639120134181,2,9.98572104987683,2,19.0403690376278,7,1,"chain",5,10.983977836286
12.1789078686021,2,26.9780055644087,5,48.8838942809614,8,1,"chain",6,36.7049864123593
12.4096903788492,2,26.9780055644087,5,33.1929072409696,4,1,"chain",2,20.7832168621204
13.8075328064808,2,26.9780055644087,5,40.6049938302136,5,1,"chain",3,26.7974610237328
0.531016607426147,3,8.86675975364243,4,12.2464664869276,1,1,"chain",2,11.7154498795015
5.16528371755164,3,8.86675975364243,4,12.2464664869276,1,1,"chain",2,7.08118276937596
5.44906662376444,3,8.39350261762996,1,23.985520709487,8,1,"chain",5,18.5364540857226
5.9362309074014,3,8.86675975364243,4,12.2464664869276,1,1,"chain",2,6.3102355795262
6.78535632185732,3,8.86675975364243,4,12.2464664869276,1,1,"chain",2,5.46111016507028
7.52603749882048,3,8.39350261762996,1,15.6310820698491,5,1,"chain",2,8.10504457102862
7.69769230762115,3,8.39350261762996,1,20.458845524454,6,1,"chain",3,12.7611532168328
7.70003243533512,3,8.39350261762996,1,20.458845524454,6,1,"chain",3,12.7588130891189
8.50883732862993,3,14.6048219734328,5,21.6441329377055,1,1,"chain",2,13.1352956090756
8.91369654031485,3,29.6816701477375,5,54.7705445267212,10,1,"chain",7,45.8568479864064
7.64135877952626,4,13.6468775093204,5,20.8222861838188,2,1,"chain",2,13.1809274042925
12.0257551784471,4,13.6468775093204,5,20.8222861838188,2,1,"chain",2,8.7965310053717
14.5478963136679,4,33.2136870651606,3,35.9380377818234,2,1,"chain",2,21.3901414681555
0.78705421693839,5,1,3,6.1895941335903,8,1,"chain",3,5.40253991665191
9.38407892722941,5,15.6310820698491,1,26.4477593061415,10,1,"chain",5,17.0636803789121
9.86270494344639,5,15.6310820698491,1,24.2190553367053,9,1,"chain",4,14.3563503932589
2.10764344626417,6,4.41730420577684,3,6.62321410984355,10,1,"chain",4,4.51557066357938
7.58310179097557,6,20.458845524454,1,26.4477593061415,10,1,"chain",4,18.8646575151659
10.8146936897835,6,29.3683673917369,3,35.9380377818234,2,1,"chain",4,25.1233440920399
0.189302828996413,7,5.23686429162724,5,20.8222861838188,2,1,"chain",5,20.6329833548224
9.36257106355444,7,39.2017190548002,2,40.769598387346,5,1,"chain",2,31.4070273237916
9.76204252284383,7,39.2017190548002,2,46.5134377382104,1,1,"chain",6,36.7513952153666
1.61516910263648,8,3.07568745954323,5,8.68695533687038,6,1,"chain",2,7.0717862342339
5.15011952399864,8,37.0796217887451,2,40.769598387346,5,1,"chain",3,35.6194788633474
6.19519171446218,8,37.0796217887451,2,44.6957880529446,2,1,"chain",6,38.5005963384824
3.35725401514477,9,16.6289579804386,3,32.4635867295654,5,1,"chain",4,29.1063327144206
8.02909657627855,9,16.6289579804386,3,33.2136870651606,4,1,"chain",5,25.1845904888821
8.10247194445893,9,16.6289579804386,3,35.9380377818234,2,1,"chain",7,27.8355658373645
0.912721207826259,10,1,5,3.07568745954323,8,1,"chain",2,2.16296625171697
3.11859694417707,10,15.5275899363634,3,33.8703476595792,3,1,"chain",7,30.7517507154021
8.33170410523763,10,15.5275899363634,3,22.0160355361707,7,1,"chain",3,13.6843314309331
5.41244833328226,1,10.7494267425115,2,29.9270207737912,10,1,"chain",9,24.5145724405089
5.41604354659774,1,10.7494267425115,2,21.0991999234164,4,1,"chain",3,15.6831563768187
5.84654945562341,1,10.7494267425115,2,23.2241664148772,5,1,"chain",4,17.3776169592538
5.86090642315083,1,10.7494267425115,2,29.9270207737912,10,1,"chain",9,24.0661143506404
5.96648770387444,1,10.7494267425115,2,23.5560671718557,6,1,"chain",5,17.5895794679813
6.33718974844712,1,10.7494267425115,2,29.9270207737912,10,1,"chain",9,23.5898310253441
9.15528230830625,1,10.7494267425115,2,21.0991999234164,4,1,"chain",3,11.9439176151102
9.66747987266228,1,10.7494267425115,2,28.4800174431822,9,1,"chain",8,18.8125375705199
9.97825445789441,1,10.7494267425115,2,18.3468253648374,3,1,"chain",2,8.36857090694299
11.1486700222926,1,21.7986079744655,4,54.2739458047238,9,1,"chain",8,43.1252757824312
0.652235292384537,2,6.50479491402335,1,18.6077806787543,10,1,"chain",8,17.9555453863698
1.51912196304373,2,6.50479491402335,1,14.3298631574286,8,1,"chain",6,12.8107411943849
1.78646187156163,2,6.50479491402335,1,18.6077806787543,10,1,"chain",8,16.8213188071927
4.43016554260786,2,6.50479491402335,1,12.0369835457547,5,1,"chain",3,7.60681800314684
5.27348476955351,2,6.50479491402335,1,13.0089469684974,6,1,"chain",4,7.73546219894389
5.331927105595,2,6.50479491402335,1,9.34048236012944,4,1,"chain",2,4.00855525453444
7.23051069649532,2,24.5659205148182,4,60.9430160328586,10,1,"chain",8,53.7125053363633
8.23424566691861,2,24.5659205148182,4,60.9430160328586,10,1,"chain",8,52.70877036594
9.27911876385676,2,24.5659205148182,4,37.4494263905863,4,1,"chain",2,28.1703076267295
9.36626739323349,2,24.5659205148182,4,38.9353117268992,5,1,"chain",3,29.5690443336657
0.82451858274163,3,30.9592520973348,5,49.4717052907731,8,1,"chain",5,48.6471867080315
1.00461215475099,3,30.9592520973348,5,38.9353117268992,5,1,"chain",2,37.9306995721482
1.38986377793625,3,30.9592520973348,5,47.0214117100224,7,1,"chain",4,45.6315479320861
1.55886375208646,3,30.9592520973348,5,43.7381523710022,6,1,"chain",3,42.1792886189157
3.17725101123488,3,30.9592520973348,5,38.9353117268992,5,1,"chain",2,35.7580607156643
3.47868028339854,3,30.9592520973348,5,56.682642335306,10,1,"chain",7,53.2039620519075
3.95204181280843,3,30.9592520973348,5,47.0214117100224,7,1,"chain",4,43.069369897214
6.64668382562126,3,30.9592520973348,5,38.9353117268992,5,1,"chain",2,32.2886279012779
6.85329613645921,3,10.9658615463029,4,19.8932098813015,1,1,"chain",2,13.0399137448423
9.10990935363515,3,30.9592520973348,5,54.2739458047238,9,1,"chain",6,45.1640364510886
9.00069870633594,4,48.7970885568447,3,65.5956635035293,9,1,"chain",5,56.5949647971934
12.5032876333209,4,48.7970885568447,3,54.8270851820664,6,1,"chain",2,42.3237975487455
15.7597365254364,4,48.7970885568447,3,63.0134714970315,7,1,"chain",3,47.2537349715951
0.325429692553977,5,1,3,8.22780323619623,7,1,"chain",2,7.90237354364225
2.89979512944474,5,30.2879475615898,1,42.8852990123797,2,1,"chain",3,39.985503882935
7.58835004445376,5,38.9353117268992,4,54.2739458047238,9,1,"chain",4,46.68559576027
0.81114331415544,6,1.79700773554602,3,11.7923969018685,9,1,"chain",3,10.9812535877131
2.91905390719573,6,13.0089469684974,1,18.6077806787543,10,1,"chain",4,15.6887267715586
5.00476844608784,6,13.0089469684974,1,16.5068000400558,9,1,"chain",3,11.502031593968
4.72227388344018,7,9.17772521301463,5,13.4947865155178,5,1,"chain",2,8.77251263207762
7.3697433119785,7,9.17772521301463,5,19.951556766612,2,1,"chain",5,12.5818134546335
7.56264597135496,7,9.17772521301463,5,21.3077125938039,1,1,"chain",6,13.7450666224489
3.27506838706609,8,7.60371812189486,5,21.3077125938039,1,1,"chain",7,18.0326442067378
3.72464485153302,8,10.3552007758471,3,17.8458440720641,10,1,"chain",2,14.1211992205311
8.82820779737386,8,27.4632518533181,3,39.1176747504396,1,1,"chain",7,30.2894669530657
2.3679643961132,9,3.13798984536938,5,9.17772521301463,7,1,"chain",2,6.80976081690143
5.17790866056391,9,24.4936662777472,3,37.439753512589,2,1,"chain",7,32.2618448520251
16.9720235545065,9,24.4936662777472,3,33.0349475666019,4,1,"chain",5,16.0629240120954
0.570074231490302,10,1,5,19.951556766612,2,1,"chain",8,19.3814825351217
5.07705162743613,10,21.9648290603393,3,37.439753512589,2,1,"chain",8,32.3627018851529
8.45242578055252,10,21.9648290603393,3,35.8807751661793,3,1,"chain",7,27.4283493856268
0.833716561975789,1,1,1,24.1980684803732,9,1,"chain",8,23.3643519183974
0.894966236275381,1,1,1,2.8014388139841,3,1,"chain",2,1.90647257770872
5.83122185677382,1,9.04705999208946,4,19.2515246403922,4,1,"chain",3,13.4203027836184
6.73636888950936,1,9.04705999208946,4,19.6670227321383,5,1,"chain",4,12.9306538426289
11.2210074200183,1,35.7914074385211,5,43.2452120428191,5,1,"chain",4,32.0242046228008
11.4465877682144,1,35.7914074385211,5,45.3389425198817,9,1,"chain",8,33.8923547516673
13.2439905393966,1,35.7914074385211,5,40.3339585647721,4,1,"chain",3,27.0899680253755
13.2824543261066,1,35.7914074385211,5,45.3389425198817,9,1,"chain",8,32.0564881937751
14.0637476657062,1,35.7914074385211,5,45.3389425198817,9,1,"chain",8,31.2751948541755
14.4942228098876,1,35.7914074385211,5,39.4651438103035,3,1,"chain",2,24.9709210004159
0.0232994565740228,2,1.93875304833055,1,23.2930530639765,8,1,"chain",6,23.2697536074025
0.367669525090605,2,1.93875304833055,1,10.2824173133238,6,1,"chain",4,9.91474778823319
0.915095323696733,2,1.93875304833055,1,5.92407037754799,5,1,"chain",3,5.00897505385126
2.90483652605655,2,3.90632107715733,2,17.8337132814306,6,1,"chain",4,14.9288767553741
3.72990316270897,2,14.108784179783,4,19.6670227321383,5,1,"chain",3,15.9371195694293
6.26734411635918,2,14.108784179783,4,19.6670227321383,5,1,"chain",3,13.3996786157791
6.88048749522788,2,14.108784179783,4,20.7781408147189,6,1,"chain",4,13.897653319491
7.76543033257192,2,14.108784179783,4,19.2515246403922,4,1,"chain",2,11.4860943078203
11.1710907679612,2,14.108784179783,4,31.9268014434925,9,1,"chain",7,20.7557106755313
13.6378148786025,2,14.108784179783,4,29.4919245956807,7,1,"chain",5,15.8541097170782
0.175217626265107,3,3.46563839379812,4,4.41870632003982,1,1,"chain",2,4.24348869377471
0.380443276708124,3,7.19367422519315,2,30.6186993953415,8,1,"chain",5,30.2382561186334
3.28085735270697,3,16.0584902716767,5,33.5154948152208,1,1,"chain",2,30.2346374625138
6.09009463701673,3,7.19367422519315,2,17.8337132814306,6,1,"chain",3,11.7436186444139
6.41391676343389,3,7.19367422519315,2,17.8337132814306,6,1,"chain",3,11.4197965179967
9.36667057451781,3,72.0961425999269,4,87.0829801096982,10,1,"chain",7,77.7163095351804
11.7634711240926,3,72.0961425999269,4,83.229676246291,8,1,"chain",5,71.4662051221984
12.8320431795991,3,72.0961425999269,4,79.4762862797334,6,1,"chain",3,66.6442431001343
15.7638017471219,3,72.0961425999269,4,87.0829801096982,10,1,"chain",7,71.3191783625763
15.9988311465169,3,72.0961425999269,4,81.916710950152,7,1,"chain",4,65.9178798036351
0.581561694853008,4,4.82180255619106,1,10.2824173133238,6,1,"chain",2,9.70085561847079
7.19914779815136,4,11.9522827774031,2,29.4919245956807,7,1,"chain",3,22.2927767975293
11.2842231901463,4,76.7690368776649,3,91.6798853044523,10,1,"chain",6,80.395662114306
4.56137198009495,5,43.2452120428191,5,46.5320406791478,10,1,"chain",5,41.9706686990529
5.12725003390473,5,47.1741538396569,4,54.9128214056453,2,1,"chain",3,49.7855713717406
7.36338830724569,5,43.2452120428191,5,46.5320406791478,10,1,"chain",5,39.1686523719021
2.11756428548445,6,45.1926926854909,4,49.1320367741061,4,1,"chain",2,47.0144724886216
5.04179310815686,6,10.2824173133238,1,23.2930530639765,8,1,"chain",2,18.2512599558196
5.48103606003924,6,45.1926926854909,4,54.5007529552177,3,1,"chain",3,49.0197168951785
0.996460376427261,7,4.07410974274067,5,33.5154948152208,1,1,"chain",6,32.5190344387935
1.23309451343609,7,4.07410974274067,5,23.310249155191,2,1,"chain",5,22.0771546417549
1.91185202793025,7,4.07410974274067,5,33.5154948152208,1,1,"chain",6,31.6036427872905
8.6473337494603,8,23.2930530639765,1,32.9625444257832,10,1,"chain",2,24.3152106763229
12.1815584269103,8,28.9967011999169,3,53.5245705777952,1,1,"chain",7,41.3430121508849
13.3003780815191,8,28.9967011999169,3,40.9960760901448,4,1,"chain",4,27.6956980086257
10.1700017278442,9,24.5698324300747,3,34.8730129903195,6,1,"chain",3,24.7030112624753
13.7888147343417,9,24.5698324300747,3,49.3284042895762,3,1,"chain",6,35.5395895552345
18.0698052733203,9,24.5698324300747,3,53.5245705777952,1,1,"chain",8,35.4547653044749
0.188027736181851,10,1,5,23.310249155191,2,1,"chain",8,23.1222214190091
0.627288304030732,10,1,5,14.289258242558,5,1,"chain",5,13.6619699385273
4.94732916751889,10,23.6501040699652,3,49.3284042895762,3,1,"chain",7,44.3810751220573
1.57883597529473,1,5.3469256835749,2,18.0734865173948,4,1,"chain",3,16.4946505421001
4.93328357203372,1,5.3469256835749,2,24.1599100257794,7,1,"chain",6,19.2266264537457
4.94319859667644,1,5.3469256835749,2,28.344995199657,8,1,"chain",7,23.4017966029806
5.23114412100017,1,10.1406374815681,4,28.9046859086222,9,1,"chain",8,23.673541787622
5.69915798081979,1,10.1406374815681,4,19.9854152703933,6,1,"chain",5,14.2862572895735
6.1408419349134,1,10.1406374815681,4,29.5151937075388,10,1,"chain",9,23.3743517726254
6.99537469450803,1,10.1406374815681,4,29.5151937075388,10,1,"chain",9,22.5198190130308
8.43135814736996,1,10.1406374815681,4,15.8487260249368,3,1,"chain",2,7.41736787756684
9.4678557206962,1,10.1406374815681,4,20.9949848047034,7,1,"chain",6,11.5271290840072
12.4817487819708,1,27.6990946409543,5,29.4276941971638,3,1,"chain",2,16.945945415193
0.542860847432166,2,1.28471076115966,1,2.86842741255634,4,1,"chain",2,2.32556656512417
0.925094637088478,2,1.28471076115966,1,13.5270718944626,10,1,"chain",8,12.6019772573741
0.970829335952687,2,1.28471076115966,1,13.5270718944626,10,1,"chain",8,12.5562425585099
1.44652175621926,2,7.48554470253545,2,20.4847800498473,5,1,"chain",3,19.038258293628
2.0068931267397,2,7.48554470253545,2,28.344995199657,8,1,"chain",6,26.3381020729173
3.61935822515593,2,7.48554470253545,2,28.344995199657,8,1,"chain",6,24.7256369745011
3.87946000755529,2,7.48554470253545,2,22.4843025285105,6,1,"chain",4,18.6048425209552
4.17474997802402,2,7.48554470253545,2,20.4847800498473,5,1,"chain",3,16.3100300718233
4.75471483277852,2,7.48554470253545,2,20.4847800498473,5,1,"chain",3,15.7300652170688
5.84944733281842,2,7.48554470253545,2,28.9046859086222,9,1,"chain",7,23.0552385758038
0.116478958638015,3,2.9462499499003,4,5.15752482615612,1,1,"chain",2,5.0410458675181
2.08773841095659,3,20.0807306052004,5,26.0263741543204,1,1,"chain",2,23.9386357433638
3.08532082137678,3,29.4276941971638,5,35.7253397938003,8,1,"chain",5,32.6400189724235
4.50266090883957,3,29.4276941971638,5,35.7253397938003,8,1,"chain",5,31.2226788849607
5.14895137968557,3,20.0807306052004,5,26.0263741543204,1,1,"chain",2,20.8774227746348
5.97482902655917,3,20.0807306052004,5,26.0263741543204,1,1,"chain",2,20.0515451277612
6.29457639582994,3,29.4276941971638,5,46.10709730969,10,1,"chain",7,39.8125209138601
6.48043203732538,3,29.4276941971638,5,33.5392752405166,5,1,"chain",2,27.0588432031912
6.81301172316614,3,29.4276941971638,5,44.2459158057146,9,1,"chain",6,37.4329040825485
6.84625255327999,3,29.4276941971638,5,35.7253397938003,8,1,"chain",5,28.8790872405203
5.6926278477786,4,67.9378660851892,4,80.3836558366291,10,1,"chain",6,74.6910279888505
8.10374268948246,4,67.9378660851892,4,74.5300741607298,7,1,"chain",3,66.4263314712473
8.12691722062943,4,67.9378660851892,4,79.7805111910907,9,1,"chain",5,71.6535939704613
0.351555485588809,5,1,4,2.9462499499003,3,1,"chain",2,2.59469446431149
2.30989303439856,5,14.2951834688933,5,20.0807306052004,3,1,"chain",2,17.7708375708018
20.6027553655339,5,34.3893164194288,3,39.0214844454248,3,1,"chain",2,18.4187290798909
0.947590403569241,6,3.14301379008405,3,5.29165312101306,8,1,"chain",2,4.34406271744382
1.51630213794609,6,3.14301379008405,3,13.5270718944626,10,1,"chain",4,12.0107697565165
11.7423849392048,6,32.4917813205121,1,50.3012127730696,1,1,"chain",5,38.5588278338648
1.71647812550267,7,8.85940951249664,5,25.432927125731,2,1,"chain",5,23.7164490002283
3.26125829635809,7,8.85940951249664,5,15.4558953920795,4,1,"chain",3,12.1946370957214
13.094943976423,7,26.9318808880231,3,50.3012127730696,1,1,"chain",6,37.2062687966466
0.214983405651803,8,5.29165312101306,3,13.5270718944626,10,1,"chain",2,13.3120884888108
10.6764245842082,8,23.8840308497796,4,29.5151937075388,10,1,"chain",2,18.8387691233306
17.0110082749391,8,23.1594517513439,3,28.2772998051314,6,1,"chain",2,11.2662915301923
0.9595432303225,9,5.38372496354921,5,26.0263741543204,1,1,"chain",8,25.0668309239979
3.40240265248419,9,5.38372496354921,5,14.2951834688933,5,1,"chain",4,10.8927808164091
5.37731582459759,9,21.1396410276818,3,34.3893164194288,5,1,"chain",4,29.0120005948312
2.64647408995434,10,18.5811595862806,3,42.2158346847688,2,1,"chain",8,39.5693605948145
3.14169322126512,10,18.5811595862806,3,50.3012127730696,1,1,"chain",9,47.1595195518045
4.41078976248358,10,18.5811595862806,3,23.1594517513439,8,1,"chain",2,18.7486619888603
0.123832949902862,1,1,1,10.3626224376536,6,1,"chain",5,10.2387894877507
0.746200105641037,1,1,1,28.5351570215269,9,1,"chain",8,27.7889569158859
0.850854525342584,1,1,1,15.1690148242797,7,1,"chain",6,14.3181602989371
1.28201221395284,1,13.631900384434,4,34.1040254517397,6,1,"chain",5,32.8220132377869
2.97888600910994,1,13.631900384434,4,34.1040254517397,6,1,"chain",5,31.1251394426298
3.51783381673487,1,13.631900384434,4,47.162283857888,9,1,"chain",8,43.6444500411531
3.93715915820541,1,13.631900384434,4,31.0061449002503,4,1,"chain",3,27.0689857420449
5.26960460177127,1,13.631900384434,4,32.3074441579237,5,1,"chain",4,27.0378395561524
6.84044546035634,1,13.631900384434,4,50.1857664492729,10,1,"chain",9,43.3453209889166
10.0065789980768,1,13.631900384434,4,32.3074441579237,5,1,"chain",4,22.3008651598469
0.630679969210178,2,4.60309200996493,1,9.23448713083872,5,1,"chain",3,8.60380716162854
2.29093996101039,2,4.60309200996493,1,6.51901904199354,4,1,"chain",2,4.22807908098315
2.79144610269907,2,4.60309200996493,1,26.4694951532633,8,1,"chain",6,23.6780490505642
3.27196570663693,2,4.60309200996493,1,10.3626224376536,6,1,"chain",4,7.09065673101667
5.47437024468041,2,26.3540070565264,2,32.3074441579237,5,1,"chain",3,26.8330739132433
6.95855012134113,2,26.3540070565264,2,32.3074441579237,5,1,"chain",3,25.3488940365826
7.41042649595221,2,26.3540070565264,2,43.0613514523992,7,1,"chain",5,35.650924956447
7.69867523795148,2,26.3540070565264,2,32.3074441579237,5,1,"chain",3,24.6087689199722
9.19149094288372,2,26.3540070565264,2,43.0613514523992,7,1,"chain",5,33.8698605095155
14.2500785402727,2,26.3540070565264,2,31.8353007624977,4,1,"chain",2,17.585222222225
0.873051603282702,3,50.5947498725313,5,62.7838251669247,9,1,"chain",6,61.910773563642
5.31517440889427,3,7.41600609435493,4,8.5026044187674,1,1,"chain",2,3.18743000987313
6.29525711167524,3,50.5947498725313,5,56.9837638965292,5,1,"chain",2,50.688506784854
11.2323761929407,3,50.5947498725313,5,64.4619594858407,10,1,"chain",7,53.2295832929
11.3596283021928,3,50.5947498725313,5,59.2986064321315,6,1,"chain",3,47.9389781299387
12.1482187508002,3,17.0054237284614,5,23.9326146746803,1,1,"chain",2,11.7843959238801
13.31486865719,3,50.5947498725313,5,59.2986064321315,6,1,"chain",3,45.9837377749415
13.4713408498016,3,50.5947498725313,5,59.2986064321315,6,1,"chain",3,45.8272655823299
14.6222173187384,3,50.5947498725313,5,59.2986064321315,6,1,"chain",3,44.6763891133931
15.291570862881,3,50.5947498725313,5,62.7838251669247,9,1,"chain",6,47.4922543040437
0.169939619178573,4,6.18368120838828,4,8.5026044187674,1,1,"chain",3,8.33266479958883
0.734329054442545,4,53.874695130461,3,64.3883478644543,8,1,"chain",4,63.6540188100118
3.80079180453871,4,53.874695130461,3,68.9865283748095,10,1,"chain",6,65.1857365702708
1.16316442171764,5,32.3074441579237,2,49.9479411140661,9,1,"chain",4,48.7847766923485
2.86663190410815,5,32.3074441579237,2,43.0613514523992,7,1,"chain",2,40.194719548291
3.48485022887619,5,32.3074441579237,2,43.0613514523992,7,1,"chain",2,39.576501223523
2.40487941837215,6,3.69684073506835,3,10.7192860046392,8,1,"chain",2,8.31440658626705
7.81296720065387,6,10.3626224376536,1,28.5351570215269,9,1,"chain",3,20.722189820873
14.1717870029759,6,34.1040254517397,4,44.8658664361477,8,1,"chain",2,30.6940794331718
0.473566681396102,7,7.23714385061682,5,14.8779677221377,4,1,"chain",3,14.4044010407416
4.04128770582876,7,7.23714385061682,5,21.0164303836571,2,1,"chain",5,16.9751426778283
4.31828617300934,7,7.23714385061682,5,14.8779677221377,4,1,"chain",3,10.5596815491284
2.88313909109338,8,5.93876065503158,5,21.0164303836571,2,1,"chain",6,18.1332912925637
6.14180600946818,8,24.5386999464337,3,30.7492037106607,5,1,"chain",3,24.6073977011925
13.2193268837955,8,24.5386999464337,3,38.2207083503686,2,1,"chain",6,25.0013814665731
0.0244496809318662,9,3.10132347841539,5,17.0054237284614,3,1,"chain",6,16.9809740475295
14.6914933287519,9,22.3108157585874,3,28.8542574500267,6,1,"chain",3,14.1627641212748
16.8527062647956,9,22.3108157585874,3,34.7803343047267,4,1,"chain",5,17.9276280399311
0.828461778409991,10,1,5,21.0164303836571,2,1,"chain",8,20.1879686052471
1.48101441350849,10,17.0655241806544,3,34.7803343047267,4,1,"chain",6,33.2993198912182
3.09540678690892,10,17.0655241806544,3,26.2717885256488,7,1,"chain",3,23.1763817387399
0.466644950211048,1,1,1,10.4985154658022,7,1,"chain",6,10.0318705155912
4.53477190227664,1,14.9807828542561,4,30.2004215234438,3,1,"chain",2,25.6656496211672
5.81097559326269,1,14.9807828542561,4,55.0638400774407,10,1,"chain",9,49.252864484178
6.18009145060438,1,14.9807828542561,4,45.1094014108233,7,1,"chain",6,38.9293099602189
6.85139335706714,1,14.9807828542561,4,47.9269742287838,8,1,"chain",7,41.0755808717167
7.12591809104846,1,14.9807828542561,4,49.8686644094446,9,1,"chain",8,42.7427463183961
8.08501828993845,1,14.9807828542561,4,36.4651835626982,4,1,"chain",3,28.3801652727598
10.0519365385376,1,14.9807828542561,4,41.4134532060609,6,1,"chain",5,31.3615166675233
10.4986019028552,1,14.9807828542561,4,55.0638400774407,10,1,"chain",9,44.5652381745855
11.0380250156127,1,14.9807828542561,4,45.1094014108233,7,1,"chain",6,34.0713763952106
0.920738366390479,2,2.21780838662075,1,16.7921042956802,10,1,"chain",8,15.8713659292897
1.7458234602646,2,2.21780838662075,1,10.4985154658022,7,1,"chain",5,8.7526920055376
2.35395643823454,2,27.8129053155348,2,36.4651835626982,4,1,"chain",2,34.1112271244637
2.95488124909485,2,27.8129053155348,2,46.2692632922083,7,1,"chain",5,43.3143820431135
3.09735920429835,2,27.8129053155348,2,42.5570431857878,5,1,"chain",3,39.4596839814894
3.67898151660944,2,27.8129053155348,2,49.7347638974583,8,1,"chain",6,46.0557823808489
4.20735609541321,2,27.8129053155348,2,45.186575318374,6,1,"chain",4,40.9792192229608
5.19837049917762,2,27.8129053155348,2,42.5570431857878,5,1,"chain",3,37.3586726866102
5.61839094130681,2,27.8129053155348,2,36.4651835626982,4,1,"chain",2,30.8467926213914
9.55045358185679,2,27.8129053155348,2,46.2692632922083,7,1,"chain",5,36.7188097103515
2.34279567176912,3,3.63625220790925,1,16.7921042956802,10,1,"chain",7,14.4493086239111
3.82314233600134,3,53.484491538733,5,54.7798680225541,5,1,"chain",2,50.9567256865528
4.62191836836244,3,6.68180876790057,4,8.91456767371625,1,1,"chain",2,4.29264930535381
5.83616895152208,3,53.484491538733,5,54.7798680225541,5,1,"chain",2,48.943699071032
7.08649780880569,3,53.484491538733,5,69.9340949545798,9,1,"chain",6,62.8475971457741
7.13317884604681,3,28.984059873638,5,34.031071664475,1,1,"chain",2,26.8978928184282
11.1703454806127,3,28.984059873638,5,34.031071664475,1,1,"chain",2,22.8607261838623
11.9727200032299,3,28.984059873638,5,34.031071664475,1,1,"chain",2,22.0583516612451
12.6658625491051,3,53.484491538733,5,54.7798680225541,5,1,"chain",2,42.114005473449
12.9570739324516,3,53.484491538733,5,54.7798680225541,5,1,"chain",2,41.8227940901025
0.611370072389642,4,5.16667745609708,4,7.00317708460125,2,1,"chain",2,6.39180701221161
6.37232547287452,4,58.0709447043399,3,65.4336476190175,7,1,"chain",3,59.061322146143
7.18005865746594,4,27.5193936062761,5,34.031071664475,1,1,"chain",3,26.8510130070091
2.44503577939981,5,7.31876638222751,1,16.3926417979623,9,1,"chain",4,13.9476060185625
12.5664566490643,5,25.0833150212363,3,35.2206150520041,2,1,"chain",3,22.6541584029398
18.977316037394,5,54.7798680225541,5,75.2850898798781,10,1,"chain",5,56.3077738424841
1.62691656810542,6,20.2573978203339,5,34.031071664475,1,1,"chain",5,32.4041550963696
1.73600244734841,6,20.2573978203339,5,27.5193936062761,4,1,"chain",2,25.7833911589277
7.01135747448407,6,20.2573978203339,5,27.5193936062761,4,1,"chain",2,20.508036131792
6.31081736308146,7,17.9210642983785,3,35.2206150520041,2,1,"chain",5,28.9097976889226
8.86014183320316,7,17.9210642983785,3,25.0833150212363,5,1,"chain",2,16.2231731880331
9.54337867866171,7,17.9210642983785,3,36.9504026392773,1,1,"chain",6,27.4070239606156
1.11052479886123,8,6.61535254180309,5,20.2573978203339,6,1,"chain",2,19.1468730214727
2.60584444874881,8,6.61535254180309,5,30.4042232905452,2,1,"chain",6,27.7983788417964
3.63272755077092,8,6.61535254180309,5,20.2573978203339,6,1,"chain",2,16.624670269563
0.823562871664762,9,5.08227435515286,5,25.0833150212363,5,1,"chain",4,24.2597521495715
8.22040397631836,9,13.4713491623485,3,20.2573978203339,6,1,"chain",3,12.0369938440155
13.1784848058872,9,18.7169823686051,1,31.8026827696939,6,1,"chain",3,18.6241979638067
0.0508667960090449,10,1,5,6.61535254180309,8,1,"chain",2,6.56448574579405
0.301172761410016,10,1,5,25.0833150212363,5,1,"chain",5,24.7821422598263
5.47279267560206,10,10.4854000032346,3,35.2206150520041,2,1,"chain",8,29.747822376402
0.391290286872362,1,1,1,7.19252145961755,4,1,"chain",3,6.80123117274519
1.20704348878442,1,8.96461112907634,4,38.2165032509085,7,1,"chain",6,37.0094597621241
1.74908044030397,1,8.96461112907634,4,38.2165032509085,7,1,"chain",6,36.4674228106045
3.04252679389864,1,8.96461112907634,4,34.1962185254825,5,1,"chain",4,31.1536917315839
3.09286375180781,1,8.96461112907634,4,34.1962185254825,5,1,"chain",4,31.1033547736747
5.25179547549737,1,8.96461112907634,4,37.2686910989996,6,1,"chain",5,32.0168956235022
5.83072141440229,1,8.96461112907634,4,30.5693036537866,4,1,"chain",3,24.7385822393843
6.3417612963693,1,8.96461112907634,4,30.5693036537866,4,1,"chain",3,24.2275423574173
11.0449001430213,1,29.9625601380998,5,38.6531646630285,6,1,"chain",5,27.6082645200072
14.2457186219144,1,29.9625601380998,5,41.5875795567962,7,1,"chain",6,27.3418609348818
0.615197817329317,2,3.03405823950636,1,25.2617233597493,9,1,"chain",7,24.64652554242
2.99355275590408,2,3.03405823950636,1,29.1744770492723,10,1,"chain",8,26.1809242933682
4.03611749533524,2,21.7689785762483,2,41.5875795567962,7,1,"chain",5,37.551462061461
4.38064326235985,2,21.7689785762483,2,45.4094556320134,9,1,"chain",7,41.0288123696536
4.74055181566586,2,21.7689785762483,2,47.535197905861,10,1,"chain",8,42.7946460901951
6.36618576685838,2,21.7689785762483,2,30.5693036537866,4,1,"chain",2,24.2031178869282
7.69332334509515,2,21.7689785762483,2,30.5693036537866,4,1,"chain",2,22.8759803086915
7.95343607075908,2,21.7689785762483,2,30.5693036537866,4,1,"chain",2,22.6158675830275
8.30197062323526,2,21.7689785762483,2,45.4094556320134,9,1,"chain",7,37.1074850087781
8.99077988349558,2,21.7689785762483,2,42.8424210069984,8,1,"chain",6,33.8516411235028
0.427190017862712,3,6.05390739539534,1,25.2617233597493,9,1,"chain",6,24.8345333418866
0.8463359935903,3,2.88414930185821,4,4.04282544494193,1,1,"chain",2,3.19648945135163
2.75939183959919,3,6.05390739539534,1,14.3824241393009,6,1,"chain",3,11.6230322997017
3.6043134042405,3,6.05390739539534,1,17.3655606831835,7,1,"chain",4,13.761247278943
3.97953423246447,3,6.05390739539534,1,17.3655606831835,7,1,"chain",4,13.386026450719
4.07291422626919,3,6.05390739539534,1,29.1744770492723,10,1,"chain",7,25.1015628230031
5.27420064275853,3,6.05390739539534,1,25.2617233597493,9,1,"chain",6,19.9875227169908
5.96540793897352,3,6.05390739539534,1,8.03508862157732,5,1,"chain",2,2.0696806826038
6.35790212386987,3,33.6851404574692,5,46.1063891002351,10,1,"chain",7,39.7484869763652
9.24929434824448,3,33.6851404574692,5,37.2323785829171,5,1,"chain",2,27.9830842346726
4.25839924860402,4,36.9579610728937,5,38.6531646630285,6,1,"chain",2,34.3947654144245
4.33769546900843,4,36.9579610728937,5,46.1063891002351,10,1,"chain",6,41.7686936312267
7.69587297740636,4,10.1142828209761,5,19.9504702945877,1,1,"chain",3,12.2545973171813
9.72975321058051,5,46.854593707665,1,51.2593881769997,2,1,"chain",3,41.5296349664192
10.6079569313662,5,46.854593707665,1,51.2593881769997,2,1,"chain",3,40.6514312456335
12.3501484121493,5,34.1962185254825,4,38.2165032509085,7,1,"chain",2,25.8663548387592
2.28879847098142,6,37.2686910989996,4,40.5982930510607,9,1,"chain",3,38.3094945800793
3.13025685337683,6,37.2686910989996,4,43.0888224230656,10,1,"chain",4,39.9585655696888
3.39164600707591,6,37.2686910989996,4,43.0888224230656,10,1,"chain",4,39.6971764159897
3.00795367904906,7,5.74607002345805,3,7.86722007406627,10,1,"chain",3,4.85926639501721
6.92109188036927,7,39.2449687280766,1,48.9434979013458,3,1,"chain",4,42.0224060209765
8.0822020219883,7,39.2449687280766,1,52.1843317300721,1,1,"chain",6,44.1021297080838
0.643088817596436,8,3.62721216105754,5,17.3047155291415,2,1,"chain",6,16.6616267115451
4.66948201244974,8,38.3588237364385,1,48.9434979013458,3,1,"chain",5,44.2740158888961
7.87843625964531,8,38.3588237364385,1,48.9434979013458,3,1,"chain",5,41.0650616417005
2.51273965138598,9,23.0446263114691,3,39.2060332677262,1,1,"chain",8,36.6932936163402
2.91887244195644,9,23.0446263114691,3,28.556856667011,5,1,"chain",4,25.6379842250546
3.54520090375994,9,23.0446263114691,3,34.818043245021,2,1,"chain",7,31.2728423412611
6.12660973615257,10,19.7187889981777,3,39.2060332677262,1,1,"chain",9,33.0794235315736
6.13578691429703,10,19.7187889981777,3,31.1799007862107,3,1,"chain",7,25.0441138719137
18.9888817186289,10,19.7187889981777,3,26.286018995375,7,1,"chain",3,7.2971372767461
0.724805733400816,1,1,1,12.0405590840576,3,1,"chain",2,11.3157533506568
1.06666706197658,1,9.41249824832094,2,38.1608813428505,10,1,"chain",9,37.0942142808739
2.73337043694894,1,9.41249824832094,2,36.0485865997,9,1,"chain",8,33.3152161627511
3.90624232179684,1,9.41249824832094,2,30.8717539776288,8,1,"chain",7,26.965511655832
4.52617474747089,1,9.41249824832094,2,22.0701492325488,6,1,"chain",5,17.5439744850779
4.76911208414671,1,9.41249824832094,2,24.8262947544548,7,1,"chain",6,20.0571826703081
7.16773248273582,1,9.41249824832094,2,24.8262947544548,7,1,"chain",6,17.658562271719
7.39913558676542,1,9.41249824832094,2,30.8717539776288,8,1,"chain",7,23.4726183908634
9.82741444820677,1,34.0205956111987,5,62.2637219516573,10,1,"chain",9,52.4363075034505
9.90423105780174,1,34.0205956111987,5,43.9143354233067,4,1,"chain",3,34.010104365505
4.21692170550056,2,6.17430854970383,1,30.8717539776288,8,1,"chain",6,26.6548322721282
4.69304200748853,2,6.17430854970383,1,19.1643996467621,5,1,"chain",3,14.4713576392736
5.86162490353999,2,6.17430854970383,1,22.0869195871548,7,1,"chain",5,16.2252946836148
8.07881672238743,2,39.1502589662979,5,62.2637219516573,10,1,"chain",8,54.1849052292699
9.43477768750198,2,39.1502589662979,5,49.4015054056064,7,1,"chain",5,39.9667277181044
11.7166371386616,2,39.1502589662979,5,43.9143354233067,4,1,"chain",2,32.1976982846451
12.0042180827936,2,39.1502589662979,5,53.5076556525002,9,1,"chain",7,41.5034375697066
14.0685007030353,2,39.1502589662979,5,48.5435951443032,6,1,"chain",4,34.4750944412679
14.7090459906705,2,39.1502589662979,5,53.5076556525002,9,1,"chain",7,38.7986096618297
15.4329138770137,2,39.1502589662979,5,50.0819905269818,8,1,"chain",6,34.6490766499681
0.246018036068244,3,12.0405590840576,1,38.1608813428505,10,1,"chain",7,37.9148633067823
1.09852735115188,3,12.0405590840576,1,19.1643996467621,5,1,"chain",2,18.0658722956102
1.15158223188234,3,12.0405590840576,1,30.8717539776288,8,1,"chain",5,29.7201717457465
1.40922655923976,3,12.0405590840576,1,36.0485865997,9,1,"chain",6,34.6393600404602
2.95593128172413,3,10.3632278867869,4,22.6766070023394,1,1,"chain",2,19.7206757206153
5.020146796449,3,12.0405590840576,1,19.9896121507065,6,1,"chain",3,14.9694653542575
8.65141761278862,3,12.0405590840576,1,38.1608813428505,10,1,"chain",7,29.5094637300619
9.85388624174173,3,12.0405590840576,1,22.0869195871548,7,1,"chain",4,12.2330333454131
10.7061063793033,3,12.0405590840576,1,22.0869195871548,7,1,"chain",4,11.3808132078515
11.1666690382652,3,41.8897920318501,4,52.7714900441253,7,1,"chain",4,41.6048210058601
0.704820294243594,4,44.0013933772069,4,62.2637219516573,10,1,"chain",6,61.5589016574137
1.67044585105032,4,44.0013933772069,4,57.8537468306834,9,1,"chain",5,56.1833009796331
7.20856346893562,4,44.0013933772069,4,51.4752174607263,6,1,"chain",2,44.2666539917907
0.160652987348537,5,1,3,7.99902322313827,7,1,"chain",2,7.83837023578973
1.84619682530562,5,48.5557036493003,4,55.7325649285334,8,1,"chain",3,53.8863681032278
3.92197034011284,5,19.8195626552463,5,25.3324980644312,2,1,"chain",3,21.4105277243184
2.44126581866456,6,11.6900650402363,5,25.0320700357471,3,1,"chain",3,22.5908042170825
13.9668305333707,6,52.8404978329309,2,64.0798477309874,2,1,"chain",4,50.1130171976167
14.4682757996552,6,52.8404978329309,2,67.388161237172,1,1,"chain",5,52.9198854375168
0.103664728812873,7,5.55206213733834,5,25.0320700357471,3,1,"chain",4,24.9284053069342
0.125027413766516,7,5.55206213733834,5,21.2251787917162,4,1,"chain",3,21.1001513779497
5.6442343657901,7,7.99902322313827,3,13.8597808097066,9,1,"chain",2,8.2155464439165
3.46684715696577,8,5.51837428184879,5,11.6900650402363,6,1,"chain",2,8.22321788327053
17.2767551576388,8,28.7302291812001,3,42.7244279239318,1,1,"chain",7,25.447672766293
17.3767411234769,8,28.7302291812001,3,42.0218955830196,2,1,"chain",6,24.6451544595427
8.01050352295438,9,26.571804539195,3,35.6936410621496,4,1,"chain",5,27.6831375391952
10.1383530027812,9,26.571804539195,3,35.6936410621496,4,1,"chain",5,25.5552880593684
11.66151003654,9,26.571804539195,3,30.5484334851794,5,1,"chain",4,18.8869234486394
0.288200083499153,10,1,5,5.51837428184879,8,1,"chain",2,5.23017419834964
0.339065040246844,10,1,5,25.0320700357471,3,1,"chain",7,24.6930049955003
1.0107054279831,10,23.2396694227282,3,42.7244279239318,1,1,"chain",9,41.7137224959487
2.11232387075636,1,4.77721492751482,2,40.7448124357497,10,1,"chain",9,38.6324885649933
2.95926728242625,1,4.77721492751482,2,35.6254044164031,8,1,"chain",7,32.6661371339768
3.62020630392794,1,4.77721492751482,2,28.2391261691875,6,1,"chain",5,24.6189198652596
5.65269403527088,1,15.8057886342995,5,32.6190831934137,7,1,"chain",6,26.9663891581428
6.0438441684895,1,15.8057886342995,5,35.3215315794075,9,1,"chain",8,29.277687410918
6.96232179775887,1,15.8057886342995,5,25.2129273495519,5,1,"chain",4,18.250605551793
7.1335815320728,1,15.8057886342995,5,36.9456149924463,10,1,"chain",9,29.8120334603735
7.69404678037443,1,15.8057886342995,5,32.6190831934137,7,1,"chain",6,24.9250364130393
8.58436702085236,1,15.8057886342995,5,33.349162833303,8,1,"chain",7,24.7647958124506
8.73340225320451,1,15.8057886342995,5,25.2129273495519,5,1,"chain",4,16.4795250963474
0.468232573749312,2,3.17941846317592,1,32.6190831934137,7,1,"chain",5,32.1508506196644
1.09755872636456,2,3.17941846317592,1,32.6190831934137,7,1,"chain",5,31.5215244670491
1.25517475008853,2,3.17941846317592,1,28.2391261691875,6,1,"chain",4,26.983951419099
3.280559503947,2,5.16553527954466,2,40.7448124357497,10,1,"chain",8,37.4642529318027
5.5861900781903,2,22.4211371023314,4,28.2391261691875,6,1,"chain",4,22.6529360909972
7.02758196338689,2,22.4211371023314,4,32.6190831934137,7,1,"chain",5,25.5915012300268
7.61708315012654,2,22.4211371023314,4,28.2391261691875,6,1,"chain",4,20.622043019061
7.672339858186,2,22.4211371023314,4,38.5796438165613,10,1,"chain",8,30.9073039583753
9.1153936680279,2,22.4211371023314,4,35.0042520246362,8,1,"chain",6,25.8888583566083
9.40804762820371,2,22.4211371023314,4,38.5796438165613,10,1,"chain",8,29.1715961883576
0.125097025957672,3,12.8729048982347,2,40.7448124357497,10,1,"chain",7,40.619715409792
1.01810567433355,3,12.8729048982347,2,32.6190831934137,7,1,"chain",4,31.6009775190801
1.1427702441669,3,12.8729048982347,2,35.6254044164031,8,1,"chain",5,34.4826341722362
2.43141597820408,3,12.8729048982347,2,37.7159968305983,9,1,"chain",6,35.2845808523942
4.06614410902587,3,12.8729048982347,1,28.2391261691875,6,1,"chain",3,24.1729820601616
6.61322019448222,3,12.8729048982347,1,32.6190831934137,7,1,"chain",4,26.0058629989315
8.85031720623528,3,12.8729048982347,1,35.6254044164031,8,1,"chain",5,26.7750872101678
8.98165358231825,3,12.8729048982347,1,28.2391261691875,6,1,"chain",3,19.2574725868692
9.13500134275717,3,12.8729048982347,1,39.4550656852609,9,1,"chain",6,30.3200643425037
9.40960072308269,3,12.8729048982347,1,32.6190831934137,7,1,"chain",4,23.209482470331
2.19456815471252,4,45.8716530980212,3,60.9892329842474,10,1,"chain",6,58.7946648295349
4.49049396906048,4,11.4754898281475,5,14.6463428954645,1,1,"chain",3,10.155848926404
11.8855404866488,4,45.8716530980212,3,49.2334472037315,6,1,"chain",2,37.3479067170827
0.952421764229475,5,1,3,6.68203730427037,8,1,"chain",3,5.72961554004089
7.6372320099799,5,9.11094135428081,5,14.6463428954645,1,1,"chain",4,7.0091108854846
10.0940189590274,5,49.1648872456616,5,54.2433264820881,1,1,"chain",4,44.1493075230607
2.67862619197273,6,49.2334472037315,3,53.3510505928769,8,1,"chain",2,50.6724244009042
13.320645726517,6,27.5217216640965,3,29.9330481553583,4,1,"chain",2,16.6124024288413
13.992574813386,6,27.5217216640965,3,32.8317433137773,2,1,"chain",4,18.8391685003913
0.348606030884896,7,4.03436231727074,5,11.4754898281475,4,1,"chain",3,11.1268837972626
2.86222494391357,7,4.03436231727074,5,14.2579027809,3,1,"chain",4,11.3956778369864
5.79786594748531,7,43.9834761430724,5,54.2433264820881,1,1,"chain",6,48.4454605346028
3.65756078919673,8,42.5450962124982,5,49.1648872456616,5,1,"chain",3,45.5073264564649
4.76522429021407,8,42.5450962124982,5,49.1648872456616,5,1,"chain",3,44.3996629554475
15.9979933567427,8,42.5450962124982,5,52.3911332772389,3,1,"chain",5,36.3931399204962
1.59607481211424,9,3.33435577721226,5,14.2579027809,3,1,"chain",6,12.6618279687858
7.53732733400472,9,19.2935127363271,3,29.4396466930529,5,1,"chain",4,21.9023193590482
11.0051792141816,9,19.2935127363271,3,34.8339235952774,1,1,"chain",8,23.8287443810958
1.98990350278715,10,15.6295792172296,3,29.4396466930529,5,1,"chain",5,27.4497431902657
4.0111461483563,10,15.6295792172296,3,26.3248546793837,7,1,"chain",3,22.3137085310274
9.97511427976746,10,15.6295792172296,3,29.9330481553583,4,1,"chain",6,19.9579338755908
0.0655843946151435,1,1,1,27.0487023353618,9,1,"chain",8,26.9831179407467
0.939702483317715,1,1,1,3.26391419367624,3,1,"chain",2,2.32421171035852
2.92980930801917,1,4.35413040288566,2,26.2432121339882,6,1,"chain",5,23.313402825969
3.38277685070846,1,4.35413040288566,2,29.1632041161205,7,1,"chain",6,25.780427265412
4.62534962484573,1,21.4777822636023,4,29.7158282054319,3,1,"chain",2,25.0904785805862
5.2174767081808,1,21.4777822636023,4,39.5978260824567,9,1,"chain",8,34.3803493742759
5.83925768203994,1,21.4777822636023,4,33.2042255284322,5,1,"chain",4,27.3649678463923
5.96615552454029,1,21.4777822636023,4,36.7085919731683,7,1,"chain",6,30.742436448628
6.08130116109222,1,21.4777822636023,4,32.6188261809581,4,1,"chain",3,26.5375250198659
7.31931488212139,1,21.4777822636023,4,37.8917982611587,8,1,"chain",7,30.5724833790373
0.409973036963493,2,2.82030408352315,1,13.3272668487314,5,1,"chain",3,12.9172938117679
0.448180267969466,2,2.82030408352315,1,13.3272668487314,5,1,"chain",3,12.8790865807619
1.0936401327237,2,2.82030408352315,1,25.9560383143294,8,1,"chain",6,24.8623981816057
1.25826950595746,2,2.82030408352315,1,27.0487023353618,9,1,"chain",7,25.7904328294043
2.12066712916385,2,5.17859060560936,2,17.7724139348226,4,1,"chain",2,15.6517468056587
2.42039116691481,2,5.17859060560936,2,24.7351207993361,5,1,"chain",3,22.3147296324213
2.57953486331386,2,5.17859060560936,2,24.7351207993361,5,1,"chain",3,22.1555859360222
4.25637434899434,2,5.17859060560936,2,29.1632041161205,7,1,"chain",5,24.9068297671262
6.09576978489888,2,31.8088888631785,5,49.2365954425607,6,1,"chain",4,43.1408256576618
6.12988267375199,2,31.8088888631785,5,59.5809810284964,10,1,"chain",8,53.4510983547444
2.32430685485218,3,35.4435099378561,5,55.7585413320415,9,1,"chain",6,53.4342344771893
4.3233539497242,3,35.4435099378561,5,52.6047565701517,7,1,"chain",4,48.2814026204275
5.13154948570706,3,35.4435099378561,5,49.2365954425607,6,1,"chain",3,44.1050459568536
9.21946804086102,3,35.4435099378561,5,59.5809810284964,10,1,"chain",7,50.3615129876354
11.6616404767786,3,35.4435099378561,5,49.2365954425607,6,1,"chain",3,37.5749549657821
13.7378103307246,3,35.4435099378561,5,55.7585413320415,9,1,"chain",6,42.0207310013169
14.7600607464399,3,35.4435099378561,5,42.3629121475062,5,1,"chain",2,27.6028514010663
15.8964288301655,3,35.4435099378561,5,49.2365954425607,6,1,"chain",3,33.3401666123952
16.3316477869174,3,35.4435099378561,5,59.5809810284964,10,1,"chain",7,43.249333241579
16.8396053268494,3,17.1477836513322,5,24.2122741194702,1,1,"chain",2,7.3726687926208
1.01439194971782,4,56.3484509310074,3,77.3080568274941,10,1,"chain",6,76.2936648777763
3.31321115978769,4,4.79517917527856,4,7.54923612328864,2,1,"chain",2,4.23602496350095
4.39805486457509,4,56.3484509310074,3,67.1060628349932,6,1,"chain",2,62.7080079704181
0.773718861552576,5,1,4,6.9192711906521,3,1,"chain",2,6.14555232909952
1.43150203265326,5,10.92304939231,5,17.1477836513322,3,1,"chain",2,15.7162816186789
2.05437305097855,5,13.3272668487314,1,18.8289779570211,7,1,"chain",2,16.7746049060425
1.17265121390422,6,2.13322566449642,3,13.1388222515675,9,1,"chain",3,11.9661710376633
2.23930198233575,6,5.99813991534104,5,13.8179882188507,4,1,"chain",2,11.578686236515
2.4892491583402,6,15.0069711493652,1,29.5544184835049,10,1,"chain",4,27.0651693251647
0.219002321052055,7,8.96315616705087,3,17.9002675028883,10,1,"chain",3,17.6812651818362
3.96557149928961,7,4.75633144369637,5,10.92304939231,5,1,"chain",2,6.95747789302039
5.55144130393519,7,40.848953802575,1,45.2474196349068,5,1,"chain",2,39.6959783309716
5.10408457340606,8,12.2450980229936,3,17.9002675028883,10,1,"chain",2,12.7961829294822
5.53758675980626,8,26.1670484728694,3,43.2996060829455,1,1,"chain",7,37.7620193231392
11.9044323213385,8,26.1670484728694,3,37.0263444566902,3,1,"chain",5,25.1219121353517
1.20940175062666,9,3.20358481376776,5,13.8179882188507,4,1,"chain",5,12.608586468224
9.72297712652844,9,24.9323658392916,3,32.2531478921178,4,1,"chain",5,22.5301707655894
16.6195876097756,9,24.9323658392916,3,40.802484048529,2,1,"chain",7,24.1828964387534
0.00253401153380378,10,1,5,4.75633144369637,7,1,"chain",3,4.75379743216257
5.29788358807467,10,22.9422497346973,3,29.114503263137,6,1,"chain",4,23.8166196750623
7.59688988998436,10,22.9422497346973,3,29.114503263137,6,1,"chain",4,21.5176133731526
0.335494593251497,1,1,1,28.7023993915656,9,1,"chain",8,28.3669047983141
0.994422734715044,1,1,1,20.3241991579524,7,1,"chain",6,19.3297764232374
2.22285277205975,1,5.32493892455095,2,15.01167911701,6,1,"chain",5,12.7888263449503
2.44447982307048,1,5.32493892455095,2,12.5495370481665,5,1,"chain",4,10.105057225096
3.9035746588646,1,5.32493892455095,2,20.3241991579524,7,1,"chain",6,16.4206244990878
5.84078795724654,1,16.2738501831596,4,24.2468618071319,6,1,"chain",5,18.4060738498854
6.11707157810324,1,16.2738501831596,4,29.0295987093919,7,1,"chain",6,22.9125271312887
6.76876324578137,1,16.2738501831596,4,32.5521390891571,8,1,"chain",7,25.7833758433757
7.79325901316883,1,16.2738501831596,4,22.5623281744746,5,1,"chain",4,14.7690691613058
8.5482939026818,1,16.2738501831596,4,18.4052896786334,3,1,"chain",2,9.8569957759516
0.761364003285117,2,2.28102516615989,1,25.4156471374993,8,1,"chain",6,24.6542831342142
0.874539989619798,2,2.28102516615989,1,15.01167911701,6,1,"chain",4,14.1371391273902
2.83867912136492,2,8.54309931648496,2,30.3096535036209,10,1,"chain",8,27.470974382256
4.57724442094087,2,8.54309931648496,2,12.5495370481665,5,1,"chain",3,7.97229262722563
6.61849790564241,2,8.54309931648496,2,20.3241991579524,7,1,"chain",5,13.70570125231
7.29619068218829,2,8.54309931648496,2,30.3096535036209,10,1,"chain",8,23.0134628214326
9.20387829398219,2,27.7696723199954,5,40.6787543123499,8,1,"chain",6,31.4748760183677
11.3157302318504,2,27.7696723199954,5,30.7266923515604,4,1,"chain",2,19.41096211971
11.9344283787881,2,27.7696723199954,5,36.504086782663,7,1,"chain",5,24.5696584038749
12.5505463162785,2,27.7696723199954,5,43.1978055026326,10,1,"chain",8,30.6472591863541
0.603368536103517,3,3.84061804871055,4,13.143819281141,1,1,"chain",2,12.5404507450375
3.77047979861458,3,29.7317057291004,5,40.6787543123499,8,1,"chain",5,36.9082745137353
5.35809482096635,3,29.7317057291004,5,43.1978055026326,10,1,"chain",7,37.8397106816662
5.42549986925848,3,29.7317057291004,5,36.504086782663,7,1,"chain",4,31.0785869134045
6.81623110846438,3,29.7317057291004,5,40.6787543123499,8,1,"chain",5,33.8625232038855
6.87184231561142,3,79.7847670311189,5,94.6662358259158,6,1,"chain",3,87.7943935103044
6.96540228249969,3,79.7847670311189,5,100.810715502661,7,1,"chain",4,93.8453132201613
8.72105314360445,3,16.5089852922661,5,23.5948030244539,1,1,"chain",2,14.8737498808494
8.97432969759881,3,79.7847670311189,5,100.810715502661,7,1,"chain",4,91.8363858050622
9.43929298412853,3,79.7847670311189,5,89.6261278867755,5,1,"chain",2,80.186834902647
1.07175515654186,4,8.08552149886677,1,15.01167911701,6,1,"chain",2,13.9399239604681
3.64131860528642,4,40.8207010075553,3,46.1744883116984,2,1,"chain",2,42.533169706412
6.76376927413203,4,8.08552149886677,1,28.7023993915656,9,1,"chain",5,21.9386301174336
2.26642248841623,5,22.5623281744746,4,32.5521390891571,8,1,"chain",3,30.2857166007409
3.89097901216398,5,22.5623281744746,4,29.0295987093919,7,1,"chain",2,25.1386196972279
5.50062370641778,5,36.9163738744002,3,51.2469288225268,1,1,"chain",4,45.746305116109
0.617362310489019,6,2.58480390423704,3,7.73976633402119,10,1,"chain",4,7.12240402353217
2.81088508820782,6,94.6662358259158,5,120.474806118731,10,1,"chain",4,117.663921030523
4.59934432680408,6,10.125757000849,5,13.4296962687019,4,1,"chain",2,8.83035194189782
3.67918221576417,7,8.0355824081173,5,23.5948030244539,1,1,"chain",6,19.9156208086897
7.06814832026073,7,8.0355824081173,5,16.5089852922661,3,1,"chain",4,9.44083697200537
8.35896023210693,7,20.3241991579524,2,30.3096535036209,10,1,"chain",3,21.950693271514
13.4910224228697,8,25.4156471374993,2,30.3096535036209,10,1,"chain",2,16.8186310807512
15.1439441699755,8,25.4156471374993,2,30.3096535036209,10,1,"chain",2,15.1657093336454
16.1407174967449,8,25.4156471374993,2,30.3096535036209,10,1,"chain",2,14.168936006876
0.0107111964483092,9,2.05270779472776,5,23.5948030244539,1,1,"chain",8,23.5840918280056
6.29599666779636,9,28.2223919062599,3,35.2414309672613,6,1,"chain",3,28.9454342994649
14.0545255369754,9,28.2223919062599,3,43.8279271227166,3,1,"chain",6,29.7734015857412
0.247813854489474,10,1,5,19.8141994031008,2,1,"chain",8,19.5663855486113
1.43323215564185,10,24.9444446911351,3,35.2414309672613,6,1,"chain",4,33.8081988116194
7.78696219937903,10,24.9444446911351,3,32.1315379055116,7,1,"chain",3,24.3445757061326
1.61438449461997,1,5.76778782731448,2,32.9018451997031,5,1,"chain",4,31.2874607050831
2.28143845022708,1,5.76778782731448,2,29.678588750147,4,1,"chain",3,27.3971502999199
2.4459026371041,1,5.76778782731448,2,32.9018451997031,5,1,"chain",4,30.455942562599
2.75122797339276,1,5.76778782731448,2,24.955521150119,3,1,"chain",2,22.2042931767262
2.88330226614192,1,5.76778782731448,2,32.9018451997031,5,1,"chain",4,30.0185429335612
3.71840677070008,1,5.76778782731448,2,24.955521150119,3,1,"chain",2,21.2371143794189
4.67650171583551,1,5.76778782731448,2,48.865062885379,10,1,"chain",9,44.1885611695435
4.72251354124867,1,5.76778782731448,2,47.1488562988083,9,1,"chain",8,42.4263427575596
5.90809243507678,1,12.5901271843128,4,31.0486976996678,6,1,"chain",5,25.140605264591
7.00797996442284,1,12.5901271843128,4,33.0809886150534,7,1,"chain",6,26.0730086506306
2.3064425285144,2,5.79495509316154,1,26.6559188163092,6,1,"chain",4,24.3494762877948
2.34863535016784,2,5.79495509316154,1,42.4702962575215,10,1,"chain",8,40.1216609073537
5.56036244017972,2,17.0673705533743,4,29.678588750147,4,1,"chain",2,24.1182263099673
5.96075324119969,2,17.0673705533743,4,30.5672829469227,5,1,"chain",3,24.606529705723
6.11448052024437,2,17.0673705533743,4,38.8188809040485,10,1,"chain",8,32.7044003838041
8.93610345799405,2,17.0673705533743,4,33.0809886150534,7,1,"chain",5,24.1448851570593
9.02768989762177,2,17.0673705533743,4,30.5672829469227,5,1,"chain",3,21.5395930493009
9.09932190382738,2,17.0673705533743,4,34.9619267368637,8,1,"chain",6,25.8626048330363
10.0341778923257,2,17.0673705533743,4,30.5672829469227,5,1,"chain",3,20.533105054597
10.1840506577364,2,17.0673705533743,4,38.5997857928526,9,1,"chain",7,28.4157351351162
3.72714271189129,3,6.82589081556476,1,38.5997857928526,9,1,"chain",6,34.8726430809613
3.75931019361547,3,6.82589081556476,1,25.0271705540543,5,1,"chain",2,21.2678603604388
5.74933490360552,3,6.82589081556476,1,32.8581426418465,8,1,"chain",5,27.108807738241
6.66919885783464,3,31.8601534751456,5,40.585407703746,6,1,"chain",3,33.9162088459114
6.84909030429011,3,31.8601534751456,5,46.8401292733392,10,1,"chain",7,39.9910389690491
7.20136906832673,3,15.8187681920964,5,27.3310226401071,1,1,"chain",2,20.1296535717804
10.1531689451466,3,31.8601534751456,5,45.6754121424848,8,1,"chain",5,35.5222431973382
10.7486462896149,3,31.8601534751456,5,40.585407703746,6,1,"chain",3,29.8367614141311
12.9106315612998,3,31.8601534751456,5,45.6754121424848,8,1,"chain",5,32.764780581185
13.3778132834676,3,15.8187681920964,5,27.3310226401071,1,1,"chain",2,13.9532093566395
0.309971350555619,4,40.8720777403804,3,56.9785428409832,9,1,"chain",5,56.6685714904276
3.61189182523294,4,11.3899454616008,5,27.3310226401071,1,1,"chain",3,23.7191308148742
10.1794658814392,4,40.8720777403804,3,45.5911661084176,7,1,"chain",3,35.4117002269784
4.04963835438991,5,32.9018451997031,2,48.865062885379,10,1,"chain",5,44.8154245309891
11.148472223489,5,32.9018451997031,2,45.6754121424848,8,1,"chain",3,34.5269399189958
21.9460639290458,5,32.9018451997031,2,45.6754121424848,8,1,"chain",3,23.729348213439
6.8315435198129,6,26.6559188163092,1,32.8581426418465,8,1,"chain",2,26.0265991220336
11.5930686699213,6,45.7587568806978,4,50.7078912762226,3,1,"chain",3,39.1148226063013
13.3685685595484,6,26.6559188163092,1,42.4702962575215,10,1,"chain",4,29.1017276979731
0.858723241835833,7,4.4382619433397,5,11.3899454616008,4,1,"chain",3,10.531222219765
1.98864156535516,7,6.6259458337322,3,10.6762325356126,10,1,"chain",3,8.68759097025744
8.06611135729212,7,45.5250160262483,4,47.6055465065549,5,1,"chain",2,39.5394351492628
12.0394551933261,8,18.9659051333068,3,22.2661884905472,6,1,"chain",2,10.2267332972211
14.5794785172128,8,18.9659051333068,3,28.4237889447311,2,1,"chain",6,13.8443104275183
16.4922663862314,8,18.9659051333068,3,31.4725940560304,1,1,"chain",7,14.980327669799
0.958436242463586,9,1.75316131153227,5,6.66945432923229,5,1,"chain",4,5.7110180867687
3.9274282589122,9,18.2473588367904,3,26.1429586888063,4,1,"chain",5,22.2155304298941
5.77670998706621,9,18.2473588367904,3,23.1870169554749,5,1,"chain",4,17.4103069684087
0.670102657750249,10,1,5,23.5493720688985,2,1,"chain",8,22.8792694111483
3.0304442992002,10,15.7716430077129,3,18.9659051333068,8,1,"chain",2,15.9354608341066
4.42218575100752,10,15.7716430077129,3,31.4725940560304,1,1,"chain",9,27.0504083050229
0.638481938280165,1,1,1,7.91403738890375,5,1,"chain",4,7.27555545062358
3.75118461811439,1,4.71382404660766,2,35.1585146454101,10,1,"chain",9,31.4073300272957
4.74411863644587,1,28.0123361996762,5,34.7251525571222,3,1,"chain",2,29.9810339206763
5.4421575612628,1,28.0123361996762,5,39.7128728030331,7,1,"chain",6,34.2707152417703
5.87434975104191,1,28.0123361996762,5,46.5026299860703,10,1,"chain",9,40.6282802350284
6.3028099117779,1,28.0123361996762,5,39.7128728030331,7,1,"chain",6,33.4100628912552
6.58967603888254,1,28.0123361996762,5,36.8130916529326,5,1,"chain",4,30.2234156140501
7.74337531745581,1,28.0123361996762,5,42.7338139466183,8,1,"chain",7,34.9904386291625
9.38311856979895,1,28.0123361996762,5,44.491968924267,9,1,"chain",8,35.108850354468
12.0593342201867,1,28.0123361996762,5,44.491968924267,9,1,"chain",8,32.4326347040803
1.65763987033608,2,2.15230859736912,1,7.91403738890375,5,1,"chain",3,6.25639751856767
4.19758088493204,2,7.3847681860965,2,12.4877990463735,4,1,"chain",2,8.29021816144146
5.16658679650105,2,7.3847681860965,2,23.4253177111196,7,1,"chain",5,18.2587309146185
6.21500509296008,2,7.3847681860965,2,35.1585146454101,10,1,"chain",8,28.94350955245
6.31202553235319,2,7.3847681860965,2,23.4253177111196,7,1,"chain",5,17.1132921787664
6.48747013951045,2,7.3847681860965,2,35.1585146454101,10,1,"chain",8,28.6710445058997
10.1516411145474,2,34.6354361431325,4,42.15292151705,4,1,"chain",2,32.0012804025026
10.5068901656547,2,34.6354361431325,4,53.445509559629,10,1,"chain",8,42.9386193939743
11.687663163983,2,34.6354361431325,4,44.9975487326708,5,1,"chain",3,33.3098855686878
13.2484892661706,2,34.6354361431325,4,44.9975487326708,5,1,"chain",3,31.7490594665002
0.85513713858546,3,3.8230630986077,1,9.35499542180925,6,1,"chain",3,8.49985828322379
3.00349305646454,3,37.9840497063751,4,47.4005215475856,6,1,"chain",3,44.3970284911211
3.24506432681658,3,37.9840497063751,4,47.4005215475856,6,1,"chain",3,44.155457220769
3.40326023543192,3,37.9840497063751,4,53.445509559629,10,1,"chain",7,50.0422493241971
4.65064394538685,3,37.9840497063751,4,53.445509559629,10,1,"chain",7,48.7948656142422
5.4324608618851,3,55.1500451218674,3,58.3188866111413,6,1,"chain",3,52.8864257492562
6.95304374735138,3,55.1500451218674,3,59.0555250181194,8,1,"chain",5,52.102481270768
7.10202103538572,3,55.1500451218674,3,58.3188866111413,6,1,"chain",3,51.2168655757556
10.0411898386115,3,55.1500451218674,3,64.4625271013125,10,1,"chain",7,54.421337262701
10.6541268121833,3,55.1500451218674,3,62.6378477845136,9,1,"chain",6,51.9837209723303
2.97165847058996,4,5.06763104332571,4,16.3337266289196,1,1,"chain",3,13.3620681583296
3.87448700706611,4,6.56685779480807,1,13.0664959585537,8,1,"chain",4,9.19200895148759
4.22154640689719,4,6.56685779480807,1,9.35499542180925,6,1,"chain",2,5.13344901491206
1.51120000561264,5,7.91403738890375,1,13.0664959585537,8,1,"chain",3,11.5552959529411
6.27504465184604,5,7.91403738890375,1,9.86162474295173,7,1,"chain",2,3.58658009110569
6.78410021192465,5,9.44571221872486,5,20.8756973208527,2,1,"chain",3,14.0915971089281
3.95371050249442,6,9.35499542180925,1,16.251921709716,9,1,"chain",3,12.2982112072216
8.13909284432042,6,9.35499542180925,1,13.0664959585537,8,1,"chain",2,4.92740311423328
8.44593595064489,6,9.35499542180925,1,13.0664959585537,8,1,"chain",2,4.62056000790881
9.56772210641321,7,23.4253177111196,2,30.8347356270737,9,1,"chain",2,21.2670135206605
12.0950056324021,7,26.5195549852852,1,45.3746970487785,4,1,"chain",3,33.2796914163764
16.9644060426958,7,23.4253177111196,2,35.1585146454101,10,1,"chain",3,18.1941086027143
3.06279408858484,8,4.30456020395252,5,17.6903317929895,3,1,"chain",5,14.6275377044047
16.6742060058394,8,24.4783122825312,1,53.5856836538277,1,1,"chain",7,36.9114776479883
21.8396552138174,8,24.4783122825312,1,48.2097797585355,2,1,"chain",6,26.3701245447181
2.9976185937564,9,16.2818031852965,3,48.2097797585355,2,1,"chain",7,45.2121611647791
3.96222632829998,9,16.2818031852965,3,28.7591089275013,6,1,"chain",3,24.7968825992013
7.08194294297895,9,16.2818031852965,3,48.368180550205,1,1,"chain",8,41.286237607226
1.87354877746354,10,13.0831711725141,3,48.368180550205,1,1,"chain",9,46.4946317727415
5.22258179518648,10,13.0831711725141,3,48.2097797585355,2,1,"chain",8,42.987197963349
8.46055609726878,10,13.0831711725141,3,28.7591089275013,6,1,"chain",4,20.2985528302325
0.791030982574246,1,1,1,32.3988022979905,7,1,"chain",6,31.6077713154163
0.803282257324495,1,1,1,15.8220786365338,4,1,"chain",3,15.0187963792093
1.50593326810872,1,5.96216255502735,2,13.29995764259,4,1,"chain",3,11.7940243744813
3.40240634885896,1,5.96216255502735,2,9.88859197973485,3,1,"chain",2,6.48618563087589
4.08462214936782,1,5.96216255502735,2,9.88859197973485,3,1,"chain",2,5.80396983036703
4.26906885859836,1,5.96216255502735,2,34.6299650624467,8,1,"chain",7,30.3608962038483
7.2063983369922,1,17.1197498507687,4,25.397147022136,5,1,"chain",4,18.1907486851438
7.22959123197224,1,17.1197498507687,4,30.0626639144931,6,1,"chain",5,22.8330726825209
7.84090979275506,1,17.1197498507687,4,25.397147022136,5,1,"chain",4,17.5562372293809
9.3275152673964,1,17.1197498507687,4,34.6299650624467,8,1,"chain",7,25.3024497950503
1.21193384654344,2,9.37640561228832,2,36.5042249382273,9,1,"chain",7,35.2922910916839
2.74024267761473,2,9.37640561228832,2,32.3988022979905,7,1,"chain",5,29.6585596203758
2.9216130822487,2,9.37640561228832,2,34.6299650624467,8,1,"chain",6,31.708351980198
3.60282163690402,2,9.37640561228832,2,22.7198003498711,5,1,"chain",3,19.1169787129671
3.62657608041166,2,9.37640561228832,1,22.7198003498711,5,1,"chain",3,19.0932242694594
6.04811973524561,2,9.37640561228832,1,39.6334502183089,10,1,"chain",8,33.5853304830633
6.37912453691756,2,9.37640561228832,1,38.6244654046094,9,1,"chain",7,32.2453408676918
9.89339319187171,2,17.920969145292,4,32.3988022979905,7,1,"chain",5,22.5054091061188
10.0958721231572,2,17.920969145292,4,32.3988022979905,7,1,"chain",5,22.3029301748333
12.4259609824551,2,17.920969145292,4,32.3988022979905,7,1,"chain",5,19.9728413155354
1.26099484130265,3,9.88859197973485,2,36.5042249382273,9,1,"chain",6,35.2432300969247
3.83467681596016,3,9.88859197973485,2,36.5042249382273,9,1,"chain",6,32.6695481222671
5.6789152275113,3,9.88859197973485,2,34.6299650624467,8,1,"chain",5,28.9510498349354
6.45271480582847,3,9.88859197973485,2,36.5042249382273,9,1,"chain",6,30.0515101323988
8.12325706451372,3,9.88859197973485,2,22.7198003498711,5,1,"chain",2,14.5965432853574
10.5424884824944,3,26.4239290734355,5,35.3982060918767,10,1,"chain",7,24.8557176093823
12.5238746484763,3,26.4239290734355,5,35.3982060918767,10,1,"chain",7,22.8743314434004
14.4101190460027,3,34.6717216154001,3,39.1845683643313,1,1,"chain",2,24.7744493183286
15.7243826328469,3,26.4239290734355,5,34.1738082398134,8,1,"chain",5,18.4494256069665
17.9713709795211,3,26.4239290734355,5,32.0362620829344,7,1,"chain",4,14.0648911034133
2.81250933198145,4,30.5567638992312,3,37.8114450554315,2,1,"chain",2,34.99893572345
3.16757911740167,4,26.7282118852043,5,35.3982060918767,10,1,"chain",6,32.230626974475
7.00359502096302,4,26.7282118852043,5,30.0626639144931,6,1,"chain",2,23.0590688935301
2.72098895769223,5,22.7198003498711,1,39.6334502183089,10,1,"chain",5,36.9124612606167
6.58501237913279,5,22.7198003498711,1,34.6299650624467,8,1,"chain",3,28.0449526833139
8.61404262455114,5,46.9673253339055,5,49.8281460407553,3,1,"chain",2,41.2141034162042
0.665127624653799,6,28.0772719020301,3,30.5567638992312,4,1,"chain",2,29.8916362745774
1.91221619076582,6,2.65501275277677,3,11.5904960745043,10,1,"chain",4,9.67827988373848
2.5316831567839,6,28.0772719020301,3,39.1845683643313,1,1,"chain",5,36.6528852075474
0.316811569809752,7,5.98961498344642,3,10.5934835420019,9,1,"chain",2,10.2766719721921
2.66585368912804,7,5.98961498344642,3,10.5934835420019,9,1,"chain",2,7.92762985287386
4.05158006891188,7,9.76981909796279,5,14.3448606701014,2,1,"chain",5,10.2932806011895
4.7186806919357,8,5.4382081396725,5,11.1116659911371,5,1,"chain",3,6.3929852992014
7.03343125328632,8,34.1738082398134,5,35.3982060918767,10,1,"chain",2,28.3647748385904
13.8848900011879,8,25.1892904281574,3,30.5567638992312,4,1,"chain",4,16.6718738980433
0.244842185901609,9,4.01046319690868,5,19.2628233658335,1,1,"chain",8,19.0179811799319
0.638335428152986,9,4.01046319690868,5,12.6720013004982,3,1,"chain",6,12.0336658723452
3.98319924976678,9,4.01046319690868,5,19.2628233658335,1,1,"chain",8,15.2796241160667
0.31137562977771,10,1,5,5.4382081396725,8,1,"chain",2,5.12683250989479
4.14938725517098,10,18.4320004450459,3,30.5567638992312,4,1,"chain",6,26.4073766440602
9.18419347143612,10,18.4320004450459,3,30.5567638992312,4,1,"chain",6,21.3725704277951
